#,#,#,#,#,#,#,#,#,#,#,#,#,#,#,#,#,#,#,#,#,#,#,#,#,#,#,#,#,#,#,#,#,#,#,#,#,#,#,#,#,#,#,#,#,#,#,#,#,#,
#,#,#,#,#,#, , ,#,#,#,#,#,#,#,#,#,#,#,#,#,#, , , , , , , , ,#,#,#,#,#,#,#,#,#,#,#,#,#,#,#,#,#,#,#,#,
#,#,#, , , , , , ,#,#,#,#,#,#,#,#,#,#,#,#, , , , , , , , , , ,#,#,#,#,#,#,#,#,#,#, , , , ,#,#,#,#,#,
#,#, , , , ,#,#, , ,#,#,#,#,#,#,#,#,#,#, , , , ,#,#,#, , , , ,#,#,#,#,#,#,#,#,#, , , , , , ,#,#,#,#,
#,#, , , ,#,#,#,#, , ,#,#,#,#,#,#,#,#,#, , , ,#,#,#,#,#, , , ,#,#,#,#,#,#,#,#, , , ,#,#, , , ,#,#,#,
#,#, , ,#,#,#,#,#, , ,#,#,#,#,#,#,#,#,#, , , ,#,#,#,#,#, , ,#,#,#,#,#,#,#,#, , , ,#,#,#,#, , , ,#,#,
#,#, , ,#,#,#,#,#, , ,#,#,#,#,#,#,#,#,#, , , ,#,#,#,#,#, , ,#,#,#,#,#,#,#, , , ,#,#,#,#,#, , , ,#,#,
#,#, , ,#,#,#,#,#, , ,#,#,#,#,#,#,#,#,#,#, , ,#,#,#,#, , ,#,#,#,#,#,#,#,#, , ,#,#,#,#,#,#, , , ,#,#,
#,#,#, , ,#,#,#, , , , ,#,#,#,#,#,#,#,#,#, , , ,#,#, , ,#,#,#,#,#,#,#,#,#, , ,#,#,#,#,#,#, , ,#,#,#,
#,#,#, , , , , , , , , , ,#,#,#,#,#,#,#,#, , , , , , , ,#,#,#,#,#,#,#,#,#, , ,#,#,#,#,#, , ,#,#,#,#,
#,#,#,#, , , , , , , , , , , , ,#,#,#,#, , , , , , , ,#,#,#,#,#,#,#,#,#,#, , ,#,#,#,#, , , ,#,#,#,#,
#,#,#,#, , , , , , , , , , , , , , , , , , , , , , ,#,#,#,#,#,#,#,#,#,#,#, , , ,#,#, , , , ,#,#,#,#,
#,#,#,#, , , , ,#,#,#, , , , , , , , , , , , ,#,#,#,#,#,#,#,#,#,#,#,#,#,#, , , , , , , , ,#,#,#,#,#,
#,#,#,#, , , ,#,#,#,#,#, , , ,#,#,#,#, , , ,#,#,#,#,#,#,#,#,#,#,#,#,#,#,#, , , , , , ,#,#,#,#,#,#,#,
#,#,#,#,#, , ,#,#,#,#,#, , ,#,#,#,#,#,#, , ,#,#,#,#,#,#,#,#,#,#,#,#,#,#,#, , , , , ,#,#,#,#,#,#,#,#,
#,#,#,#,#, , ,#,#,#,#, , , ,#,#,#,#,#,#, , , ,#,#,#,#,#,#,#,#, , , ,#,#, , , , , , ,#,#,#,#,#,#,#,#,
#,#,#,#, , , , ,#, , , , , ,#,#,#,#,#,#, , , ,#,#,#,#,#,#,#, , , , , , , , , , , , ,#,#,#,#,#,#,#,#,
#,#, , , , , , , , , , , , ,#,#,#,#,#, , , ,#,#,#,#,#,#,#,#, , , , , , , , , , , , ,#,#,#,#,#,#,#,#,
#, , , , , , , , , , , , , ,#,#,#,#, , , ,#,#,#,#,#,#,#,#,#,#, , , , , , , , , , , ,#,#,#,#,#,#,#,#,
#, , , , , , , , , , , , , ,#,#,#,#, , , ,#,#,#,#,#,#,#,#,#,#, , , , , ,#,#,#, , , ,#,#,#,#,#,#,#,#,
#, , , , , , , , , , , , ,#,#,#,#,#,#,#,#,#,#,#,#,#,#,#,#,#,#,#, , , ,#,#,#,#,#,#,#,#,#,#,#,#,#,#,#,
#, , , , , , , ,#,#, , , ,#,#,#,#,#,#,#,#,#,#,#,#,#,#,#,#,#,#,#,#, , ,#,#,#,#,#,#,#,#,#,#,#,#,#,#,#,
#,#, , ,#,#,#,#,#,#,#, , , ,#,#,#,#,#,#,#,#,#,#,#,#,#,#,#,#,#,#,#, , ,#,#,#,#,#,#,#,#,#,#,#,#,#,#,#,
#,#,#,#,#,#,#,#,#,#,#, , , , , , ,#,#,#,#,#,#,#,#,#,#,#,#,#,#,#,#, , ,#,#,#,#,#,#,#,#,#,#,#,#,#,#,#,
#,#,#,#,#,#,#,#,#,#,#,#, , , , , , ,#,#,#,#, , ,#,#,#,#,#,#,#,#,#, , , ,#,#,#,#,#,#,#,#,#,#,#,#,#,#,
#,#,#,#,#,#,#,#,#,#,#, , ,#,#,#, , , ,#,#, , , ,#,#,#,#,#,#,#,#,#,#, , , , ,#,#,#,#,#,#,#,#,#,#,#,#,
#,#,#,#,#,#,#,#,#,#, , ,#,#,#,#,#, , , , , , , , ,#,#,#,#,#,#,#,#,#,#, , , , ,#,#,#,#,#,#,#,#,#,#,#,
#,#,#,#,#,#, , ,#, , ,#,#,#,#,#,#,#, , , ,#,#, , , , ,#,#,#,#,#,#,#,#,#, , , , ,#,#,#,#,#,#,#,#,#,#,
#,#,#,#, , , , , , ,#,#,#,#,#,#,#,#, , ,#,#,#,#, , , , ,#,#,#,#,#,#,#,#, , , , ,#,#,#, , , ,#,#,#,#,
#,#,#, , , , , , ,#,#,#,#,#,#,#,#,#, ,#,#,#,#,#,#, , , ,#,#,#,#,#,#,#,#,#, , , ,#,#,#, , , ,#,#,#,#,
#,#,#,#, ,#,#,#,#,#,#,#,#,#,#,#,#, , ,#,#,#,#,#,#,#, , ,#,#,#,#,#,#,#,#,#,#,#, , ,#,#,#, , ,#,#,#,#,
#,#,#,#,#,#,#,#,#,#,#,#,#,#,#,#, , , ,#,#,#,#,#,#,#, , ,#,#,#,#,#,#,#,#,#,#,#,#, , ,#,#, , ,#,#,#,#,
#,#,#,#,#,#,#,#,#,#,#,#,#,#,#,#, , , , ,#,#,#,#,#, , ,#,#,#,#,#,#,#,#,#,#,#,#,#, , ,#,#, , ,#,#,#,#,
#,#,#,#,#,#,#,#,#,#,#,#,#,#,#,#, , , , , , , , , , , ,#,#,#,#,#,#,#,#,#,#,#,#,#, , ,#,#,#, , ,#,#,#,
#,#,#,#,#,#,#,#,#,#,#,#,#,#,#, , , , , , , , , , , , ,#,#,#,#,#,#,#,#,#,#,#,#, , , ,#,#,#, , , ,#,#,
#,#,#,#,#,#,#,#,#,#,#,#,#,#, , , , , , , , , , , , , , ,#,#,#,#,#,#,#,#,#,#,#, , ,#,#,#,#, , , ,#,#,
#,#,#,#,#,#,#,#,#, , , , , , , , , , , ,#,#,#, , , , , ,#,#,#,#,#,#,#,#,#,#, , ,#,#,#,#,#,#, , ,#,#,
#,#,#,#,#, , , , , , , , , , , , , , ,#,#,#,#,#, , , , , ,#,#,#,#,#,#,#,#,#, , ,#,#,#,#,#,#, , ,#,#,
#,#,#,#, , , , , ,#,#,#,#, , , , ,#,#,#,#,#,#,#,#, , , , ,#,#,#,#,#,#,#,#, , , ,#,#,#,#,#,#, , ,#,#,
#,#,#, , , , ,#,#,#,#,#,#,#, , ,#,#,#,#,#,#,#,#,#, , , , ,#,#,#,#, , , , , , , , ,#,#,#,#, , , ,#,#,
#,#,#, , , ,#,#,#,#,#,#,#,#, , ,#,#,#,#,#,#,#,#,#, , , ,#,#,#,#, , , , , , , , , , , , , , , ,#,#,#,
#,#,#,#, , ,#,#,#,#,#,#,#, , , ,#,#,#,#,#,#,#,#,#, , ,#,#,#,#,#, , , , , , , , , , , , , , ,#,#,#,#,
#,#,#,#,#, , ,#,#,#,#,#,#, , ,#,#,#,#,#,#,#,#,#, , , ,#,#,#,#,#,#, , , , , , , , , ,#,#,#,#,#,#,#,#,
#,#,#,#,#,#, , ,#,#,#,#, , , ,#,#,#,#,#,#,#, , , , ,#,#,#,#,#,#,#, , ,#,#,#, , , ,#,#,#,#,#,#,#,#,#,
#,#,#,#,#,#, , , , , , , , ,#,#,#,#,#,#,#, , , , , ,#,#,#,#,#,#, , ,#,#,#,#,#,#,#,#,#,#,#,#,#,#,#,#,
#,#,#,#,#,#,#, , , , , , ,#,#,#,#,#,#,#,#, , , , , , ,#,#,#,#, , ,#,#,#,#,#,#,#,#,#,#,#,#,#,#,#,#,#,
#,#,#,#,#,#,#,#,#,#,#,#,#,#,#,#,#,#,#,#,#,#,#,#,#, , , ,#,#, , ,#,#,#,#,#,#,#,#,#,#,#,#,#,#,#,#,#,#,
#,#,#,#,#,#,#,#,#,#,#,#,#,#,#,#,#,#,#,#,#,#,#,#,#,#,#, , , , ,#,#,#,#,#,#,#,#,#,#,#,#,#,#,#,#,#,#,#,
#,#,#,#,#,#,#,#,#,#,#,#,#,#,#,#,#,#,#,#,#,#,#,#,#,#,#,#, , ,#,#,#,#,#,#,#,#,#,#,#,#,#,#,#,#,#,#,#,#,
#,#,#,#,#,#,#,#,#,#,#,#,#,#,#,#,#,#,#,#,#,#,#,#,#,#,#,#,#,#,#,#,#,#,#,#,#,#,#,#,#,#,#,#,#,#,#,#,#,#,
