#,#,#,#,#,#,#,#,#,#,#,#,#,#,#,#,#,#,#,#,#,#,#,#,#,#,#,#,#,#,#,#,#,#,#,#,#,#,#,#,#,#,#,#,#,#,#,#,#,#,
#,#,#,#,#,#,#,#,#,#,#,#,#,#,#,#,#,#,#,#,#,#,#,#,#,#,#,#,#,#,#,#,#,#,#,#,#,#,#,#,#,#,#,#,#,#,#,#,#,#,
#,#,#,#,#,#,#,#,#,#,#,#,#,#,#,#,#,#,#,#,#,#,#,#,#,#,#,#,#,#,#,#,#,#,#, , , , , , , , ,#,#,#,#,#,#,#,
#,#,#,#,#,#,#,#,#,#,#, , , , ,#,#,#,#,#,#,#, , ,#,#,#,#,#,#,#,#,#,#, , , , , , , , , , ,#,#,#,#,#,#,
#,#,#,#,#,#,#,#,#,#, , , , , , ,#,#,#,#, , , , , ,#,#,#,#,#,#,#,#, , , , ,#,#,#,#, , , ,#,#,#,#,#,#,
#,#,#,#,#,#,#,#,#,#, , , , , , , , , , , , , , , , ,#,#,#,#,#,#,#, , , ,#,#,#,#,#,#, , ,#,#,#,#,#,#,
#,#,#,#,#,#,#,#,#,#, , , , , , , , , ,#,#,#,#, , , ,#,#,#,#,#,#,#, , , ,#,#,#,#,#,#, , ,#,#,#,#,#,#,
#,#,#,#,#,#,#,#,#,#, , , , , , , , ,#,#,#,#,#,#, , ,#,#,#,#,#,#,#,#, , ,#,#,#,#,#, , , ,#,#,#,#,#,#,
#,#,#,#,#,#,#,#,#, , , , , , , , , ,#,#,#,#,#,#, , ,#,#,#,#,#,#,#,#, , ,#,#,#,#,#, , , ,#,#,#,#,#,#,
#,#,#,#,#,#,#,#, , , , , , , , , , ,#,#,#,#,#,#, , , ,#,#,#,#,#,#,#, , , ,#,#,#,#, , , ,#,#,#,#,#,#,
#,#,#,#,#,#,#,#, , , , , , , , , , , ,#,#,#,#,#, , , ,#,#,#,#,#,#,#,#, , , ,#,#, , , ,#,#,#,#,#,#,#,
#,#,#,#,#, ,#,#,#, , , , , , , , , , , ,#,#,#, , , ,#,#,#,#,#,#,#,#,#,#, , , , , , ,#,#,#,#,#,#,#,#,
#,#,#,#, , , ,#,#, , , ,#,#, , , , , , , , , , , , ,#,#,#,#,#,#,#,#,#,#,#, , , , , ,#,#,#,#,#,#,#,#,
#,#,#,#, , , ,#,#, , ,#,#,#,#,#,#,#,#,#, , , , , , ,#,#,#,#,#,#,#,#,#,#,#,#, , , , , ,#,#,#,#,#,#,#,
#,#,#,#, , ,#,#,#, , , ,#,#,#,#,#,#,#,#,#, , , , , , ,#,#,#,#,#,#, , ,#,#,#, , , , , ,#,#,#,#,#,#,#,
#,#,#, , , ,#,#,#,#, , , ,#,#,#,#,#,#,#,#, , , , , , ,#,#,#,#,#, , , , ,#,#, , , , , ,#,#,#,#,#,#,#,
#,#,#, , ,#,#,#,#,#, , , ,#,#,#,#,#,#,#,#, , , , , ,#,#,#,#,#,#, , , , ,#,#,#, , , , ,#,#,#,#,#,#,#,
#,#,#, , ,#,#,#,#,#, , , ,#,#,#,#,#,#,#, , , , , ,#,#,#,#,#,#,#,#, , ,#,#,#,#, , , , , ,#,#,#,#,#,#,
#,#,#, , ,#,#,#,#,#, , ,#,#,#,#,#,#,#,#, , , , ,#,#,#,#,#,#,#,#,#, , ,#,#,#, , , , , , , , ,#,#,#,#,
#,#,#,#, , ,#,#,#, , ,#,#,#,#,#,#,#,#,#, , , ,#,#,#,#,#,#,#,#,#, , , , ,#, , , ,#,#,#, , , , ,#,#,#,
#,#,#,#, , , , , , , ,#,#,#,#,#,#,#,#,#, , , ,#,#,#,#,#, , , , , , , , , , , ,#,#,#,#,#, , , ,#,#,#,
#,#,#,#, , , , , , , ,#,#,#,#,#,#,#,#,#,#, , ,#,#,#,#,#, , , , , , , , , , ,#,#,#,#,#,#, , , ,#,#,#,
#,#,#,#,#, , , , , , ,#,#,#,#,#,#,#,#,#,#, , ,#,#,#,#,#,#,#, , , , , , , , ,#,#,#,#,#,#, , , ,#,#,#,
#,#,#,#,#, , , , , , ,#,#,#,#,#,#,#,#,#,#, , ,#,#,#,#,#,#,#,#, , , , , , , , ,#,#,#,#, , , ,#,#,#,#,
#,#,#,#,#, , , , , , ,#,#,#,#,#,#,#,#,#,#, , ,#,#,#,#,#,#,#,#, , , , , , , , , , , , , , ,#,#,#,#,#,
#,#,#,#,#, , , , , , , ,#,#,#,#,#,#,#,#,#, , ,#,#,#,#,#,#,#, , , , , , , , , , , , , , ,#,#,#,#,#,#,
#,#,#,#,#, , , , , , , , ,#,#,#,#,#,#,#,#, , ,#,#,#,#,#,#, , , ,#,#,#,#,#,#,#,#,#,#,#,#,#,#,#,#,#,#,
#,#,#,#, , , ,#,#,#, , , , ,#,#,#,#,#,#,#, , , ,#,#,#, , , ,#,#,#,#,#,#,#,#,#,#,#,#,#,#,#,#,#,#,#,#,
#,#,#,#, , ,#,#,#,#,#,#, , , ,#,#,#,#,#,#, , , , , , , , ,#,#,#,#,#,#,#,#,#,#,#,#,#,#,#,#,#,#,#,#,#,
#,#,#,#, , ,#,#,#,#,#,#,#, , , ,#,#,#,#,#,#, , , , , , ,#,#,#,#,#,#,#,#,#,#,#,#,#,#,#,#,#,#,#,#,#,#,
#,#,#,#, , ,#,#,#,#,#,#,#, , , ,#,#,#,#,#,#,#, , , , , ,#,#,#,#,#,#,#,#,#,#,#,#,#,#,#,#,#,#,#,#,#,#,
#,#,#,#, , ,#,#,#,#,#,#, , , , ,#,#,#,#,#,#,#,#, , , , ,#,#,#,#,#,#,#,#,#,#,#,#,#,#,#,#,#,#,#,#,#,#,
#,#,#,#,#, , ,#,#,#,#, , , , , ,#,#,#,#,#,#,#,#, , , , , ,#,#,#,#,#,#,#,#,#,#,#,#,#,#,#,#,#,#,#,#,#,
#,#,#,#,#, , , ,#,#, , , , , ,#,#,#,#,#,#,#,#,#, , , , , ,#,#,#,#,#,#,#,#, , ,#,#,#,#,#,#,#,#,#,#,#,
#,#,#,#,#, , , , , , , ,#,#,#,#,#,#,#,#,#,#,#,#, , , , , , ,#,#,#,#,#,#, , , , ,#,#,#,#,#,#,#,#,#,#,
#,#,#,#, , , , , , , ,#,#,#,#,#,#,#,#,#,#,#,#, , , , , , , ,#,#,#,#,#, , , , , ,#,#,#,#,#,#,#,#,#,#,
#,#,#, , , ,#, , , , ,#,#,#,#,#,#,#,#,#,#,#, , , ,#,#, , , ,#,#,#,#,#, , , , , ,#,#,#,#,#,#,#,#,#,#,
#,#, , , ,#,#,#, , , ,#,#,#,#,#,#,#,#,#,#, , , ,#,#,#,#, , ,#,#,#,#, , , , , ,#,#,#,#,#,#,#,#,#,#,#,
#,#, , , ,#,#,#, , , ,#,#,#,#,#,#,#,#,#, , ,#,#,#,#,#,#, , , ,#,#, , , , , , ,#,#,#,#,#,#, ,#,#,#,#,
#,#,#, , , ,#,#,#, , ,#,#,#,#,#,#,#,#, , ,#,#,#,#,#,#,#,#, , , , , , , , , , ,#,#,#,#,#, , , ,#,#,#,
#,#,#,#, , ,#,#,#,#, , ,#,#,#,#,#,#,#, , ,#,#,#,#,#,#,#,#,#, , , , , , , , , ,#,#,#,#,#, , , ,#,#,#,
#,#,#,#, , ,#,#,#,#,#, , ,#,#,#,#,#,#, , ,#,#,#,#,#,#,#,#,#, , , , , , , , , , ,#,#,#, , , , ,#,#,#,
#,#,#,#, ,#,#,#,#,#,#, , , ,#,#,#,#,#, , , ,#,#,#,#,#,#,#, , , , , , , , , , , , , , , , , , ,#,#,#,
#,#,#, , ,#,#,#,#,#,#, , , ,#,#,#,#,#,#, , , ,#,#,#,#,#, , , , , , , ,#,#,#,#, , , , ,#,#,#,#,#,#,#,
#,#,#, , ,#,#,#,#,#, , , ,#,#,#,#,#,#,#,#, , , ,#,#,#, , , , ,#,#,#,#,#,#,#,#,#,#,#,#,#,#,#,#,#,#,#,
#,#,#, , ,#,#,#,#, , , ,#,#,#,#,#,#,#,#,#,#, , , , , , , , ,#,#,#,#,#,#,#,#,#,#,#,#,#,#,#,#,#,#,#,#,
#,#,#, , , ,#,#, , , ,#,#,#,#,#,#,#,#,#,#,#, , , , , , , , ,#,#,#,#,#,#,#,#,#,#,#,#,#,#,#,#,#,#,#,#,
#,#,#, , , , , , , ,#,#,#,#,#,#,#,#,#,#,#,#,#, , , , , , , ,#,#,#,#,#,#,#,#,#,#,#,#,#,#,#,#,#,#,#,#,
#,#,#,#, , , ,#,#,#,#,#,#,#,#,#,#,#,#,#,#,#,#,#,#,#,#, , ,#,#,#,#,#,#,#,#,#,#,#,#,#,#,#,#,#,#,#,#,#,
#,#,#,#,#,#,#,#,#,#,#,#,#,#,#,#,#,#,#,#,#,#,#,#,#,#,#,#,#,#,#,#,#,#,#,#,#,#,#,#,#,#,#,#,#,#,#,#,#,#,
