#,#,#,#,#,#,#,#,#,#,#,#,#,#,#,#,#,#,#,#,#,#,#,#,#,#,#,#,#,#,#,#,#,#,#,#,#,#,#,#,#,#,#,#,#,#,#,#,#,#,
#,#,#,#,#,#,#,#,#,#,#,#,#,#,#,#,#,#,#,#,#,#,#,#,#,#,#,#,#,#,#,#,#,#,#,#,#,#,#, , , , , ,#,#,#,#,#,#,
#,#,#,#,#,#,#,#,#,#,#,#,#,#,#,#,#,#,#, , , ,#,#,#,#, , ,#,#,#,#,#,#,#,#,#,#, , , , , , , , ,#,#,#,#,
#,#,#,#,#,#,#,#,#,#,#,#,#,#,#,#,#,#, , , , , , , , , , , ,#,#,#,#,#,#,#,#, , , ,#,#,#,#, , , ,#,#,#,
#,#,#,#, , , , , , , ,#,#,#,#,#,#,#, , , , , , , , , , , ,#,#,#,#,#,#,#,#, , ,#,#,#,#,#,#, , ,#,#,#,
#,#,#, , , , , , , , , ,#,#,#,#,#,#, , , , , , , , , , , ,#,#,#,#,#,#,#,#, , ,#,#,#,#,#,#, , ,#,#,#,
#,#,#, , ,#,#,#,#,#,#, , , ,#,#,#, , , , , ,#,#,#, , , , ,#,#,#,#,#,#,#,#, , ,#,#,#,#,#, , , ,#,#,#,
#,#, , ,#,#,#,#,#,#,#,#, , , , , , , , , ,#,#,#,#,#, , , ,#,#,#,#,#,#,#,#, , , ,#,#,#, , , ,#,#,#,#,
#,#, , ,#,#,#,#,#,#,#,#, , , , , , , , ,#,#,#,#,#,#,#, , ,#,#,#,#,#,#,#,#, , , , , , , , ,#,#,#,#,#,
#,#, , , ,#,#,#,#,#,#, , , , , , , , , ,#,#,#,#,#,#,#, , ,#,#,#,#,#,#,#,#,#, , , , , , ,#,#,#,#,#,#,
#,#, , , , ,#,#,#, , , , , , , , , , , , ,#,#,#,#,#, , , , ,#,#,#,#,#,#,#,#, , , , , ,#,#,#,#,#,#,#,
#,#,#, , , , , , , , , , , ,#,#,#,#, , , , , , , , , , , , , ,#,#,#,#,#,#, , , , , ,#,#,#,#,#,#,#,#,
#,#,#,#, , , , , , , , ,#,#,#,#,#,#,#, , , , , , , , ,#,#, , , , , , , , , , , , , ,#,#,#,#,#,#,#,#,
#,#,#,#,#, , , , , ,#,#,#,#,#,#,#,#,#,#,#,#,#,#,#,#,#,#,#,#, , , , , , , , , , , ,#,#,#,#,#,#,#,#,#,
#,#,#,#,#, , , , ,#,#,#,#,#,#,#,#,#,#,#,#,#,#,#,#,#,#,#,#,#,#, , , , , ,#,#,#, , ,#,#,#,#,#,#,#,#,#,
#,#,#,#, , , , , ,#,#,#,#,#,#,#,#,#,#,#,#,#,#,#,#,#,#,#,#,#,#, , , , ,#,#,#,#,#, , ,#,#,#,#,#,#,#,#,
#,#,#, , , , , , ,#,#,#,#,#,#,#,#,#,#,#,#,#,#,#,#,#,#,#,#,#, , , , ,#,#,#,#,#,#, , , ,#,#,#,#,#,#,#,
#,#, , , , , , ,#,#,#,#,#,#,#,#,#,#,#,#,#,#,#,#,#,#,#,#,#,#, , , , ,#,#,#,#,#,#, , , ,#,#,#,#,#,#,#,
#,#, , , , ,#,#,#,#,#,#,#,#,#,#,#,#,#,#,#,#,#,#,#,#,#,#,#,#,#, , ,#,#,#,#,#,#,#, , , ,#,#,#,#,#,#,#,
#,#, , , ,#,#,#,#,#,#,#,#,#,#,#,#,#, ,#,#,#,#,#,#,#,#,#,#,#,#,#,#,#,#,#,#,#,#,#,#, ,#,#,#,#,#,#,#,#,
#,#, , , ,#,#,#,#,#,#,#,#,#,#,#,#, , , ,#,#,#,#,#,#,#,#,#,#,#,#,#,#,#,#,#,#,#,#,#,#,#,#,#,#,#,#,#,#,
#,#, , ,#,#,#,#,#,#,#,#,#,#,#,#,#, , , , ,#,#,#,#,#,#,#,#,#,#,#,#,#,#,#,#,#,#,#,#,#,#,#,#,#,#,#,#,#,
#, , ,#,#,#,#,#,#,#,#,#,#,#,#,#,#, , , , , ,#,#,#,#,#,#,#,#,#,#,#,#,#,#,#,#,#,#,#,#,#,#,#,#,#,#,#,#,
#, , ,#,#,#,#,#,#,#,#,#,#,#,#,#, , , , , , ,#,#,#,#,#,#,#,#,#,#,#,#,#,#,#,#,#,#,#,#,#,#,#,#,#,#,#,#,
#, , ,#,#,#,#,#,#,#,#,#,#,#, , , , , , , , , ,#,#,#,#,#,#,#,#,#,#,#,#,#,#,#,#,#,#,#,#,#,#,#,#,#,#,#,
#, , ,#,#,#,#,#,#,#,#, , , , , ,#,#,#, , , , ,#,#,#,#,#,#,#,#,#,#,#,#,#,#,#,#,#,#,#,#,#,#,#,#,#,#,#,
#, , ,#,#,#,#,#,#,#, , , , , ,#,#,#,#,#, , , ,#,#,#,#,#,#,#,#,#,#,#,#,#,#,#,#,#,#,#,#,#,#,#,#,#,#,#,
#,#, , ,#,#,#,#,#, , , , , , ,#,#,#,#,#, , , ,#,#,#,#,#,#,#,#,#,#,#,#, ,#,#,#,#,#,#,#,#,#,#,#,#,#,#,
#,#,#, , , , , , , , , , , , ,#,#,#,#,#,#, , ,#,#,#,#,#,#,#,#,#,#,#, , , ,#,#,#,#,#,#,#,#,#,#,#,#,#,
#,#,#,#, , , , , , , , , , , ,#,#,#,#,#,#, , ,#,#,#,#,#,#,#,#,#,#,#, , , ,#,#,#,#,#,#,#,#,#,#,#,#,#,
#,#,#,#,#,#,#,#,#,#, , , , , ,#,#,#,#,#,#, , ,#,#,#,#,#,#,#,#,#,#,#,#, , ,#,#,#,#,#,#,#,#,#,#,#,#,#,
#,#,#,#,#,#,#,#,#,#,#, , , , , ,#,#,#,#, , , , ,#,#,#,#,#,#,#,#,#,#,#, , ,#,#,#,#,#,#,#,#,#,#,#,#,#,
#,#,#,#,#,#,#,#,#,#,#, , , , , , , , , , , , , ,#,#,#,#,#,#,#,#,#,#,#, , , ,#,#,#,#,#,#,#,#,#,#,#,#,
#,#,#,#,#,#,#,#,#,#, , , , , , , , , , , , , , ,#,#,#,#,#,#,#,#,#,#,#,#, , , ,#,#,#,#,#,#,#,#,#,#,#,
#,#,#,#,#, , , , , , , , , , , ,#,#,#, , , , , ,#,#,#,#,#,#,#,#,#,#,#,#, , , , , , , ,#,#,#,#,#,#,#,
#,#,#,#, , , , , , , , , , , ,#,#,#,#,#, , , , , ,#,#,#,#,#,#,#,#,#,#,#, , , , , , , , ,#,#,#,#,#,#,
#,#,#,#, , , , , , , , , , ,#,#,#,#,#,#, , , , , , , , , , ,#,#,#,#,#, , , , , , , , , ,#,#,#,#,#,#,
#,#,#,#, , , , , , , , , ,#,#,#,#,#,#,#, , , , , , , , , , , , , , , , , , , , , , , , ,#,#,#,#,#,#,
#,#,#,#, , , , , , , , , ,#,#,#,#,#,#,#, , , , ,#,#,#,#, , , , , , , , , , , ,#,#,#, , , ,#,#,#,#,#,
#,#,#,#, , , , , , , , ,#,#,#,#,#,#,#,#, , , ,#,#,#,#,#,#, , , , , , , , , ,#,#,#,#,#, , ,#,#,#,#,#,
#,#,#, , , ,#,#,#, , , ,#,#,#,#,#,#,#,#, , , ,#,#,#,#,#,#,#, , , , , , , ,#,#,#,#,#,#,#, , ,#,#,#,#,
#,#, , , ,#,#,#,#,#, , ,#,#,#,#,#,#,#,#, , , ,#,#,#,#,#,#,#, , , , , , , ,#,#,#,#,#,#,#, , ,#,#,#,#,
#,#, , ,#,#,#,#,#,#, , , ,#,#,#,#,#,#,#,#, , ,#,#,#,#,#,#, , , , , , , , , ,#,#,#,#,#,#, , ,#,#,#,#,
#,#, , ,#,#,#,#,#,#, , , ,#,#,#,#,#,#,#,#, , , ,#,#,#, , , , , , , , , , , , ,#,#,#,#,#, , ,#,#,#,#,
#,#, , , ,#,#,#,#, , , ,#,#,#,#,#,#,#,#,#,#, , , , , , , , ,#,#,#,#,#, , , , , ,#,#,#,#, , , ,#,#,#,
#,#,#, , , , , , , , ,#,#,#,#,#,#,#,#,#,#,#, , , , , , ,#,#,#,#,#,#,#,#,#, , , , ,#,#, , , , ,#,#,#,
#,#,#,#, , , , , , ,#,#,#,#,#,#,#,#,#,#,#,#,#, , , , ,#,#,#,#,#,#,#,#,#,#,#,#,#, , , , , , ,#,#,#,#,
#,#,#,#,#,#,#,#,#,#,#,#,#,#,#,#,#,#,#,#,#,#,#,#,#,#,#,#,#,#,#,#,#,#,#,#,#,#,#,#,#, , , ,#,#,#,#,#,#,
#,#,#,#,#,#,#,#,#,#,#,#,#,#,#,#,#,#,#,#,#,#,#,#,#,#,#,#,#,#,#,#,#,#,#,#,#,#,#,#,#,#,#,#,#,#,#,#,#,#,
#,#,#,#,#,#,#,#,#,#,#,#,#,#,#,#,#,#,#,#,#,#,#,#,#,#,#,#,#,#,#,#,#,#,#,#,#,#,#,#,#,#,#,#,#,#,#,#,#,#,
