#,#,#,#,#,#,#,#,#,#,#,#,#,#,#,#,#,#,#,#,#,#,#,#,#,#,#,#,#,#,#,#,#,#,#,#,#,#,#,#,#,#,#,#,#,#,#,#,#,#,
#,#,#,#,#,#,#, , , , , , , ,#,#,#,#,#,#,#,#,#,#,#,#,#,#,#,#,#,#,#, , , , , , , , ,#,#,#,#,#,#,#,#,#,
#,#,#,#,#,#, , , , , , , , , ,#,#,#,#,#,#,#,#,#,#,#,#,#,#,#, , , , , , , , , , , , ,#,#,#, , ,#,#,#,
#,#,#,#,#, , , ,#,#,#,#, , , ,#,#,#,#,#,#,#,#,#,#,#,#,#,#, , , , , ,#,#,#,#,#, , , ,#,#, , , , ,#,#,
#,#,#,#, , , ,#,#,#,#,#,#, , , ,#,#,#,#,#,#,#,#,#,#,#,#, , , , , ,#,#,#,#,#,#,#, , ,#, , , , , ,#,#,
#,#,#, , , ,#,#,#,#,#,#,#, , , ,#,#,#,#,#,#,#,#,#,#,#,#, , , , ,#,#,#,#,#,#,#,#, , , , , , , ,#,#,#,
#,#,#, , , ,#,#,#,#,#,#,#, , , ,#,#,#,#,#,#,#,#,#,#,#,#,#, , , ,#,#,#,#,#,#,#, , , , ,#,#,#,#,#,#,#,
#,#,#, , , , ,#,#,#,#,#, , , ,#,#,#,#,#,#,#,#,#,#,#,#,#,#, , , , ,#,#,#,#,#, , , , , ,#,#,#,#,#,#,#,
#,#,#,#, , , ,#,#,#,#, , , ,#,#,#,#,#,#,#,#,#,#,#,#,#,#, , , , , , ,#,#, , , , , , ,#,#,#,#,#,#,#,#,
#,#,#,#,#, , , ,#,#, , , , ,#,#,#,#,#,#,#,#,#,#, , , , , , , ,#, , , , , , , , ,#,#,#,#,#,#,#,#,#,#,
#,#,#,#,#,#, , , , , , , ,#,#,#,#,#,#,#,#,#, , , , , , , , ,#,#,#, , , , , ,#,#,#,#,#,#,#,#,#,#,#,#,
#,#,#,#,#,#, , , , , , , ,#,#,#,#,#,#,#,#, , , , , , , , , , ,#, , , , , ,#,#,#,#,#,#,#,#,#,#,#,#,#,
#,#,#,#,#,#, , , , , , , ,#,#,#,#,#,#,#, , , ,#,#,#,#, , , , , , , , , , ,#,#,#,#,#,#,#,#,#,#,#,#,#,
#,#,#,#,#, , , , , , , , ,#,#,#,#,#,#, , , ,#,#,#,#,#,#, , , , ,#,#, , ,#,#,#,#,#,#,#,#,#,#,#,#,#,#,
#,#,#,#, , , , , , , , , ,#,#,#,#,#,#, , , ,#,#,#,#,#,#,#, , ,#,#,#,#,#,#,#,#,#,#,#,#,#,#,#,#,#,#,#,
#,#,#,#, , , , , , , , , ,#,#,#,#,#,#, , , ,#,#,#,#,#,#,#, , ,#,#,#,#,#,#,#,#,#,#, , , , , ,#,#,#,#,
#,#,#,#,#,#,#,#,#,#, , , ,#,#,#,#,#,#,#, , , ,#,#,#,#,#,#, , ,#,#,#,#,#,#,#,#,#, , , , , , , ,#,#,#,
#,#,#,#,#,#,#,#,#,#,#, , , ,#,#,#,#,#,#,#, , ,#,#,#,#,#, , , , ,#,#,#,#,#,#,#, , , ,#,#,#, , , ,#,#,
#,#,#,#,#,#,#,#,#,#,#, , , ,#,#,#,#,#,#,#, , , ,#,#, , , , , , , ,#,#,#,#,#,#, , ,#,#,#,#,#, , ,#,#,
#,#,#,#,#,#,#,#,#,#, , , ,#,#,#,#,#,#,#,#, , , , , , , , , , , , ,#,#,#,#,#,#, , ,#,#,#,#,#, , ,#,#,
#,#,#,#,#,#,#,#,#,#, , ,#,#,#,#,#,#,#,#, , , , , , , , , , , , , ,#,#,#,#,#,#, , ,#,#,#,#,#, , ,#,#,
#,#,#,#,#,#,#,#,#,#, , ,#,#,#,#,#,#,#, , , , , , , , ,#,#,#,#,#,#,#,#,#,#,#,#, , , ,#,#,#, , , ,#,#,
#,#,#,#,#,#,#,#,#,#, , , ,#,#,#,#,#, , , , , , , , ,#,#,#,#,#,#,#,#,#,#,#,#, , , , , , , , , , ,#,#,
#,#,#, , ,#,#,#,#,#, , , , , , , , , , , , , , , , ,#,#,#,#,#,#,#,#,#,#,#, , , , , , , , , , ,#,#,#,
#,#, , , , ,#,#,#,#, , , , , , , , , ,#,#, , , , ,#,#,#,#,#,#,#,#,#,#, , , , , , , , , , , ,#,#,#,#,
#,#, , , , , , , , , , , , , , , , ,#,#,#,#, , , ,#,#,#,#,#,#, , , , , , , , , , , , , ,#,#,#,#,#,#,
#,#,#, , , , , , , , , , , , , ,#,#,#,#,#,#, , , ,#,#,#,#,#, , , , , , , , , , , , , ,#,#,#,#,#,#,#,
#,#,#,#,#, , , , , , , , , , ,#,#,#,#,#,#,#, , , , ,#,#,#, , , ,#,#,#,#, , , , , , , ,#,#,#,#,#,#,#,
#,#,#,#,#,#, , , , , , , , , ,#,#,#,#,#,#,#, , , , , , , , , ,#,#,#,#,#,#, , , , , ,#,#,#,#,#,#,#,#,
#,#,#,#,#,#,#, , , , , , , , , ,#,#,#,#,#, , , , , , , , , ,#,#,#,#,#,#,#, , , , ,#,#,#,#,#,#,#,#,#,
#,#,#,#,#,#,#, , , , , , , , , , ,#,#,#, , , , , , , , , , ,#,#,#,#,#,#,#, , , ,#,#,#,#,#,#,#,#,#,#,
#,#,#,#,#,#,#, , , , , , , , , , , , , , , , , , , , , , , , ,#,#,#,#,#,#, , ,#,#,#,#,#,#,#,#,#,#,#,
#,#,#,#,#,#,#,#, , , , , , , , , , , , , , , , , , ,#,#, , , , ,#,#,#,#, , , ,#,#,#,#,#,#,#,#,#,#,#,
#,#,#,#,#,#,#,#, , , , , , , , , ,#,#,#,#,#,#,#,#,#,#,#,#, , , , , , , , , , , ,#,#,#,#, , ,#,#,#,#,
#,#,#,#,#,#,#,#, , , , , , , , ,#,#,#,#,#,#,#,#,#,#,#,#,#, , , , , , , , , , , , ,#,#, , , , ,#,#,#,
#,#,#,#, , ,#, , , , , , , , ,#,#,#,#,#,#,#,#,#,#,#,#,#,#, , , , , , , , , , , , , , , , , , ,#,#,#,
#,#,#, , , , , , , , , , , ,#,#,#,#,#,#,#,#,#,#,#,#,#,#, , , , , ,#,#,#, , , , , , , , , , , ,#,#,#,
#,#, , , , , , , , , , , , ,#,#,#,#,#,#,#,#,#,#, , , , , , , , ,#,#,#,#,#, , , , ,#,#,#, , , ,#,#,#,
#,#, , , , ,#,#,#, , , , ,#,#,#,#,#,#,#,#,#,#, , , , , , , , , ,#,#,#,#,#, , , ,#,#,#,#,#, , , ,#,#,
#,#, , , ,#,#,#,#,#, , , ,#,#,#,#,#,#,#,#, , , , , , , , , , ,#,#,#,#,#,#, , , ,#,#,#,#,#,#, , ,#,#,
#,#,#, , ,#,#,#,#,#, , , ,#,#,#,#,#,#,#, , , , , ,#,#, , , ,#,#,#,#,#,#,#, , , ,#,#,#,#,#,#, , ,#,#,
#,#,#, , ,#,#,#,#,#, , ,#,#,#,#,#,#,#, , , , , ,#,#,#,#, , ,#,#,#,#,#,#,#, , , ,#,#,#,#,#, , , ,#,#,
#,#,#,#, , ,#,#,#,#, , ,#,#,#,#,#,#, , , , , ,#,#,#,#,#, , ,#,#,#,#,#,#,#, , , , ,#,#, , , , , ,#,#,
#,#,#,#, , , ,#,#, , , ,#,#,#,#,#,#, , , , , ,#,#,#,#,#, , , ,#,#,#,#,#, , , , , , , , , , , ,#,#,#,
#,#,#,#,#, , , , , , ,#,#,#,#,#,#,#,#, , , , ,#,#,#,#,#, , , ,#,#,#,#,#,#, , , , , , , ,#,#,#,#,#,#,
#,#,#,#,#,#, , , , , ,#,#,#,#,#,#,#,#, , , , , ,#,#,#, , , ,#,#,#,#,#,#,#,#,#,#,#, , ,#,#,#,#,#,#,#,
#,#,#,#,#,#,#, , , ,#,#,#,#,#,#,#,#,#,#, , , , , , , , , ,#,#,#,#,#,#,#,#,#,#,#,#,#,#,#,#,#,#,#,#,#,
#,#,#,#,#,#,#,#,#,#,#,#,#,#,#,#,#,#,#,#,#, , , , , , , ,#,#,#,#,#,#,#,#,#,#,#,#,#,#,#,#,#,#,#,#,#,#,
#,#,#,#,#,#,#,#,#,#,#,#,#,#,#,#,#,#,#,#,#,#,#,#,#,#,#,#,#,#,#,#,#,#,#,#,#,#,#,#,#,#,#,#,#,#,#,#,#,#,
#,#,#,#,#,#,#,#,#,#,#,#,#,#,#,#,#,#,#,#,#,#,#,#,#,#,#,#,#,#,#,#,#,#,#,#,#,#,#,#,#,#,#,#,#,#,#,#,#,#,
