#,#,#,#,#,#,#,#,#,#,#,#,#,#,#,#,#,#,#,#,#,#,#,#,#,#,#,#,#,#,#,#,#,#,#,#,#,#,#,#,#,#,#,#,#,#,#,#,#,#,
#,#,#,#,#,#,#,#,#,#,#,#,#,#,#,#,#,#,#,#,#,#,#,#,#,#,#,#,#,#,#, , , , ,#,#,#,#,#,#,#,#,#,#,#,#,#,#,#,
#,#,#,#,#,#,#,#,#,#,#,#,#,#,#,#,#,#,#,#,#,#,#,#,#,#,#,#,#, , , , , , , , , ,#,#,#,#,#,#,#,#,#,#,#,#,
#,#,#,#,#, , ,#,#,#, , ,#,#,#,#,#,#,#,#,#,#,#,#,#,#,#,#, , , ,#,#,#,#, , , ,#,#,#,#,#,#,#,#,#,#,#,#,
#,#,#,#, , , , , , , , , ,#,#,#,#,#,#,#,#,#,#,#,#,#,#,#, , ,#,#,#,#,#,#, , ,#,#,#,#,#,#,#,#,#,#,#,#,
#,#,#,#, , , , , , , , , ,#,#,#,#,#,#,#,#,#,#,#,#,#,#,#,#, ,#,#,#,#,#,#,#,#,#,#,#,#,#,#,#,#,#,#,#,#,
#,#,#,#, , , , ,#,#,#, , , ,#,#,#,#,#,#,#,#,#,#,#,#,#,#,#, , ,#,#,#,#,#,#,#,#,#,#,#,#,#,#,#,#,#,#,#,
#,#,#,#,#, , ,#,#,#,#,#, , ,#,#,#,#,#,#,#,#,#, , , ,#,#,#, , , ,#,#,#,#,#,#,#,#,#,#,#,#,#,#,#,#,#,#,
#,#,#,#,#, , ,#,#,#,#,#,#, , ,#,#,#,#,#,#,#,#, , , ,#,#,#, , , , ,#,#,#,#,#,#,#,#,#,#,#,#,#,#,#,#,#,
#,#,#,#,#,#, , ,#,#,#,#,#,#, , ,#,#,#,#,#,#,#, , , ,#,#,#,#, , , , , , , , , , , , , ,#,#,#,#,#,#,#,
#,#,#,#,#,#, , ,#,#,#,#,#,#, , , ,#,#,#,#,#, , , ,#,#,#,#,#,#,#,#, , , , , , , , , , , ,#,#,#,#,#,#,
#,#,#,#,#,#,#, , ,#,#,#,#, , , , ,#,#,#,#,#, , , ,#,#,#,#,#,#,#,#,#, , , , , , , , , , , ,#,#,#,#,#,
#,#,#,#,#,#,#,#, , , , , , , , , , ,#,#,#,#, , , ,#,#,#,#,#,#,#,#,#,#, , , , , , , , , , , ,#,#,#,#,
#,#,#,#,#,#,#,#,#, , , , , , , , , , ,#,#, , , , , ,#,#,#,#,#,#,#,#,#,#, , , , ,#,#,#, , , , ,#,#,#,
#,#,#,#,#,#,#,#,#,#,#,#, , , , , , , , , , , , , , , ,#,#,#,#,#,#,#,#,#,#, , , ,#,#,#,#, , , ,#,#,#,
#,#,#,#,#,#,#,#,#,#,#,#,#, , , , , , , , , , , , , , , ,#,#,#,#,#,#,#,#,#,#, , ,#,#,#,#,#, , ,#,#,#,
#,#,#,#,#,#,#,#,#,#,#,#,#, , , , , , , , ,#,#,#,#, , , ,#,#,#,#,#,#,#,#,#,#, , ,#,#,#,#,#, , ,#,#,#,
#,#,#,#,#,#,#,#,#,#,#,#,#,#, , , , , ,#,#,#,#,#,#,#, , , ,#,#,#,#,#,#,#,#,#, , ,#,#,#,#,#, , ,#,#,#,
#,#,#,#,#,#,#,#,#,#,#,#,#,#, , , , ,#,#,#,#,#,#,#,#, , , ,#,#,#,#,#,#,#,#,#, , ,#,#,#,#, , , ,#,#,#,
#,#,#,#,#,#,#,#,#,#,#,#,#, , , , , ,#,#,#,#,#,#,#,#,#, , ,#,#,#,#,#,#,#,#,#, , , ,#,#, , , , ,#,#,#,
#,#,#,#,#,#,#,#,#,#, , , , , , , , , ,#,#,#,#,#,#,#,#, , ,#,#,#,#,#,#,#,#,#, , , , , , , , ,#,#,#,#,
#,#,#,#,#,#,#,#,#, , , , , , , , , , , ,#,#,#,#,#,#, , , ,#,#,#,#,#,#,#,#,#, , , , ,#,#,#,#,#,#,#,#,
#,#,#,#,#,#,#,#, , , , , , , , , , , , ,#,#,#,#,#, , , ,#,#,#,#,#,#,#,#,#,#, , , ,#,#,#,#,#,#,#,#,#,
#,#,#,#,#,#,#, , , , ,#,#,#,#, , , , , , ,#,#,#, , , ,#,#,#,#,#,#,#,#,#,#, , , , ,#,#,#,#,#,#,#,#,#,
#,#,#,#,#,#, , , , , ,#,#,#,#,#,#,#,#, , , , , , , ,#,#,#,#,#,#,#,#,#,#, , , , , ,#,#,#,#,#,#,#,#,#,
#,#,#,#, , , , , , , ,#,#,#,#,#,#,#,#,#, , , , , , ,#,#,#,#,#,#,#,#, , , , , , , , ,#,#,#,#,#,#,#,#,
#,#, , , , ,#,#, , , , ,#,#,#,#,#,#,#,#, , , , , , ,#,#,#,#,#,#,#, , , , , , , , , ,#,#,#, , ,#,#,#,
#, , , , ,#,#,#,#, , , ,#,#,#,#,#,#,#,#, , , , , , ,#,#,#,#,#,#, , , , , , , , , ,#,#,#, , , , ,#,#,
#, , , ,#,#,#,#,#, , , ,#,#,#,#,#,#,#, , , , , , , ,#,#,#,#,#, , , ,#,#,#, , , , , ,#, , , , , ,#,#,
#, , , ,#,#,#,#,#, , ,#,#,#,#,#,#,#, , , , , , , , ,#,#,#,#,#, , ,#,#,#,#,#, , , , , , , , , ,#,#,#,
#, , , , ,#,#,#, , , ,#,#,#,#,#,#, , , , ,#,#, , , , ,#,#,#, , ,#,#,#,#,#,#, , , , , , , , ,#,#,#,#,
#,#, , , , , , , , , ,#,#,#,#,#,#, , , ,#,#,#,#, , , ,#,#, , , ,#,#,#,#,#,#, , , , , , , , ,#,#,#,#,
#,#,#, , , , , , , , ,#,#,#,#,#,#, , ,#,#,#,#,#,#, , ,#,#, , , ,#,#,#,#,#,#, , , , , , , , ,#,#,#,#,
#,#,#,#, , , , , ,#,#,#,#,#,#,#,#, , ,#,#,#,#,#,#, , ,#,#,#, , ,#,#,#,#,#,#, , , , , , , , , ,#,#,#,
#,#,#,#,#, , , ,#,#,#,#,#,#,#,#,#, , ,#,#,#,#,#,#, , ,#,#,#,#, , ,#,#,#,#,#, , , , , , , , , , ,#,#,
#,#,#,#,#,#, , ,#,#,#,#,#,#,#,#, , ,#,#,#,#,#,#,#, , ,#,#,#,#,#, , ,#,#,#, , , , ,#,#,#,#,#, , ,#,#,
#,#,#,#,#,#, , , , , ,#,#,#,#, , , ,#,#,#,#,#,#,#, , ,#,#,#,#,#, , , , , , , , ,#,#,#,#,#,#,#, , ,#,
#,#,#,#,#,#, , , , , , , , , , , , ,#,#,#,#,#,#, , , , ,#,#,#,#, , , , , , , , ,#,#,#,#,#,#,#, , ,#,
#,#,#,#,#,#, , , ,#,#, , , , , , , , ,#,#,#, , , , , , , ,#,#, , , , , , , , , , ,#,#,#,#,#,#, , ,#,
#,#,#,#,#, , , ,#,#,#,#, , , , , , , , , , , , , , , , , , , , , , , , , , , , , , ,#,#,#,#,#, , ,#,
#,#,#,#, , , ,#,#,#,#,#,#, , , , , , , , , , , , , , , , , , , , , , , ,#,#,#, , , , ,#,#,#, , , ,#,
#,#,#,#, , ,#,#,#,#,#,#,#, , , , , , , , ,#,#,#, , , , , , ,#,#, , , , ,#,#,#,#, , , , , , , , ,#,#,
#,#,#,#, , ,#,#,#,#,#,#,#, , , , , , , ,#,#,#,#,#, , , , ,#,#,#,#, , , ,#,#,#,#,#, , , , , , , ,#,#,
#,#,#,#, , ,#,#,#,#,#,#,#, , , , , ,#,#,#,#,#,#,#,#, , , ,#,#,#,#,#, , ,#,#,#,#,#, , , , , , ,#,#,#,
#,#,#,#, , ,#,#,#,#,#,#, , , , ,#,#,#,#,#,#,#,#,#,#,#, , ,#,#,#,#,#, , ,#,#,#,#, , , , , , , ,#,#,#,
#,#,#,#, , , ,#,#,#, , , , , ,#,#,#,#,#,#,#,#,#,#,#,#, , ,#,#,#,#,#, , ,#,#,#, , , , , , , , ,#,#,#,
#,#,#,#,#, , , , , , , , , ,#,#,#,#,#,#,#,#,#,#,#,#,#, , , ,#,#,#, , , ,#,#,#, , , , , , , ,#,#,#,#,
#,#,#,#,#,#, , , , , , , ,#,#,#,#,#,#,#,#,#,#,#,#,#,#, , , , , , , , ,#,#,#,#,#, , , , , ,#,#,#,#,#,
#,#,#,#,#,#,#, , ,#,#,#,#,#,#,#,#,#,#,#,#,#,#,#,#,#,#,#, , , , , ,#,#,#,#,#,#,#,#,#,#,#,#,#,#,#,#,#,
#,#,#,#,#,#,#,#,#,#,#,#,#,#,#,#,#,#,#,#,#,#,#,#,#,#,#,#,#,#,#,#,#,#,#,#,#,#,#,#,#,#,#,#,#,#,#,#,#,#,
