#,#,#,#,#,#,#,#,#,#,#,#,#,#,#,#,#,#,#,#,#,#,#,#,#,#,#,#,#,#,#,#,#,#,#,#,#,#,#,#,#,#,#,#,#,#,#,#,#,#,
#,#,#,#,#,#,#,#,#, , , , , , ,#,#,#,#,#,#,#,#,#,#,#,#,#,#,#,#,#,#,#,#,#,#,#,#,#,#,#,#,#,#,#,#,#,#,#,
#,#,#,#,#,#,#,#, , , , , , , , ,#,#,#,#,#,#,#,#,#,#,#,#,#,#,#,#,#,#,#,#,#,#,#,#,#,#,#,#,#,#,#,#,#,#,
#,#,#,#,#,#,#,#, , , ,#,#,#, , , ,#,#,#,#,#,#,#,#,#,#,#, , , , , ,#,#,#,#,#,#,#,#,#,#,#,#, , ,#,#,#,
#,#,#,#,#,#,#,#, , ,#,#,#,#,#, , ,#,#,#,#,#,#,#,#,#, , , , , , , , , ,#,#,#,#,#,#,#,#,#,#, , , ,#,#,
#,#,#,#,#,#,#,#, , ,#,#,#,#,#, , , ,#,#,#,#,#,#,#, , , , , , , , , , , , , , ,#,#,#,#,#,#,#, , ,#,#,
#,#,#,#,#,#,#,#, , ,#,#,#,#, , , , ,#,#,#,#,#,#,#, , , ,#,#,#,#,#, , , , , , , ,#,#,#,#,#,#, , , ,#,
#,#,#,#,#,#,#,#, , , ,#,#, , , , ,#,#,#,#,#,#,#,#, , ,#,#,#,#,#,#,#, , , , , , , , ,#,#,#, , , , ,#,
#,#,#,#,#,#,#,#, , , , , , , , ,#,#,#,#,#,#,#,#,#, , ,#,#,#,#,#,#,#, , , , , , , , , , , , , , ,#,#,
#,#,#,#,#,#,#, , , , , , , , ,#,#,#,#,#,#,#,#,#,#, , , ,#,#,#,#,#, , , , , , , , , , , , , , ,#,#,#,
#,#,#,#,#, , , , ,#, , , , ,#,#,#,#,#,#,#,#,#,#,#,#, , , ,#,#,#, , , , , , , , , , , , , , , ,#,#,#,
#,#,#, , , , , , , , , , ,#,#,#,#,#,#,#,#,#,#,#,#,#, , , , , , , , , , ,#,#,#, , , , , , , , ,#,#,#,
#,#, , , ,#,#, , , , , ,#,#,#,#,#,#,#,#,#,#,#,#,#,#, , , , , , , ,#,#,#,#,#,#,#, , , , , , , ,#,#,#,
#, , , ,#,#,#,#, , , ,#,#,#,#,#,#,#,#,#,#,#,#,#,#,#,#, , , , , ,#,#,#,#,#,#,#,#, , , , , , , ,#,#,#,
#, , ,#,#,#,#,#, , , ,#,#,#,#,#,#,#,#,#,#,#,#,#,#,#,#,#, , , ,#,#,#,#,#,#,#,#,#, , , , , , , ,#,#,#,
#, , ,#,#,#,#,#, , , ,#,#,#,#,#,#, , , ,#,#,#,#,#,#,#,#,#,#,#,#,#,#,#,#,#,#,#,#,#, , , , , , ,#,#,#,
#, , ,#,#,#,#,#, , , ,#,#,#,#,#, , , , , ,#,#,#,#,#,#,#,#,#,#,#,#,#,#,#,#,#,#,#,#, , , , , , ,#,#,#,
#, , ,#,#,#,#,#,#, , , ,#,#,#, , , , , , , ,#,#,#,#,#,#,#,#,#,#,#,#,#,#,#,#,#,#, , , ,#,#, , ,#,#,#,
#, , ,#,#,#,#,#,#, , , , , , , , ,#,#,#, , , ,#,#,#,#,#,#,#,#,#,#,#,#,#,#,#,#, , , ,#,#,#,#, , ,#,#,
#,#, , ,#,#,#,#,#, , , , , , , ,#,#,#,#,#, , ,#,#,#,#,#,#,#,#,#,#,#,#,#,#,#, , , ,#,#,#,#,#,#,#,#,#,
#,#, , , , ,#,#, , , , , , , , ,#,#,#,#,#,#, , ,#,#,#,#,#,#,#,#,#,#,#,#,#, , , ,#,#,#,#,#,#,#,#,#,#,
#,#,#, , , , , , , , , , , , , ,#,#,#,#,#,#, , , , ,#,#,#,#,#, , , ,#,#, , , , ,#,#,#,#,#,#,#,#,#,#,
#,#,#, , , , , , , , , , , , , , ,#,#,#,#, , , , , , , , , , , , , , , , , , , ,#,#,#,#,#,#,#,#,#,#,
#,#,#,#, , , , , , , , ,#,#,#, , , , , , , , , , , , , , , , , , , , , , , , , , ,#,#,#,#,#,#,#,#,#,
#,#,#,#,#,#,#,#, , , ,#,#,#,#,#, , , , , , , , , ,#,#,#,#,#,#,#,#, , , , , , , , , ,#,#,#,#,#,#,#,#,
#,#,#,#,#,#,#,#,#,#,#,#,#,#,#,#,#,#,#,#,#,#, , , ,#,#,#,#,#,#,#,#,#, , , , , , , ,#,#,#,#,#,#,#,#,#,
#,#,#,#,#,#,#,#,#,#,#,#,#,#,#,#,#,#,#,#,#,#,#, , , ,#,#,#,#,#,#,#,#, , , , , ,#,#,#,#,#,#,#,#,#,#,#,
#,#,#,#,#,#,#,#,#,#,#,#,#,#,#,#,#,#,#,#,#,#,#,#, , , ,#,#,#,#,#,#,#, , , , ,#,#,#,#,#,#,#,#,#,#,#,#,
#,#,#,#,#,#,#,#,#,#,#,#,#,#,#,#,#,#,#,#,#,#,#,#, , , ,#,#,#,#,#,#,#, , , ,#,#,#,#,#,#,#,#,#,#,#,#,#,
#,#,#,#,#,#,#,#,#,#,#,#,#,#,#,#,#,#,#,#,#,#,#,#, , , ,#,#,#,#,#,#,#, , , ,#,#,#,#,#,#,#,#,#,#,#,#,#,
#,#,#, , ,#,#,#,#,#,#,#,#,#,#,#,#,#,#,#,#,#,#,#, , , ,#,#,#,#,#,#,#, , , ,#,#,#,#,#,#,#,#,#,#,#,#,#,
#,#, , , , ,#,#,#,#,#,#,#,#,#,#,#,#,#,#,#,#,#,#, , , ,#,#,#,#,#,#, , , , , ,#,#,#,#,#,#,#,#,#,#,#,#,
#,#, , , , , ,#,#,#,#,#,#,#,#,#,#,#,#,#,#,#,#,#, , , , ,#,#, , , , , , , , , ,#,#,#,#,#,#,#,#,#,#,#,
#,#,#, , , , , ,#,#,#,#,#,#,#,#,#,#,#,#,#,#,#,#, , , , , , , , , , , , , , , , ,#,#,#,#,#,#,#,#,#,#,
#,#,#,#, , , , , , ,#,#,#,#,#,#,#,#,#,#,#,#,#, , , , , , , , , , , , , , , , , ,#,#,#,#,#,#,#,#,#,#,
#,#,#,#, , , , , , , , ,#,#,#,#,#,#,#,#, , , , , , , , , , , , , , , , , , , , , ,#,#,#,#,#,#,#,#,#,
#,#,#, , ,#,#,#, , , , , , ,#,#,#,#,#, , , , , , , , , , , , ,#,#, , , , , , , , , , , ,#,#,#,#,#,#,
#,#, , ,#,#,#,#,#, , , , , , , , , , , , , ,#,#,#, , , , ,#,#,#,#,#, , , , , ,#,#, , , , ,#,#,#,#,#,
#,#, , ,#,#,#,#,#,#, , , , , , , , , , , ,#,#,#,#,#, , ,#,#,#,#,#,#, , , , ,#,#,#,#, , , ,#,#,#,#,#,
#,#, , ,#,#,#,#,#, , , , , , , , , , , ,#,#,#,#,#,#, , ,#,#,#,#,#,#, , , , ,#,#,#,#,#, , ,#,#,#,#,#,
#,#, , , ,#,#,#, , , , , , , , , , , , ,#,#,#,#,#,#, , ,#,#,#,#,#,#, , , , ,#,#,#,#,#, , ,#,#,#,#,#,
#,#, , , , , , , , , , , , , , , , , , ,#,#,#,#,#,#,#,#,#,#,#,#,#,#, , , , ,#,#,#,#,#, , ,#,#,#,#,#,
#,#,#, , , , , , ,#,#, , , , , , , , , ,#,#,#,#,#,#,#,#,#,#,#,#,#,#,#, , , , ,#,#,#, , , ,#,#,#,#,#,
#,#,#,#,#,#,#,#,#,#,#,#, , , , , , , , , ,#,#,#,#,#,#,#,#,#,#,#,#,#,#,#,#,#, , , , , , ,#,#,#,#,#,#,
#,#,#,#,#,#,#,#,#,#,#,#,#,#,#, , , , , , ,#,#,#,#,#,#,#,#,#,#,#,#,#,#,#,#,#,#, , , , ,#,#,#,#,#,#,#,
#,#,#,#,#,#,#,#,#,#,#,#,#,#,#,#, , , , , ,#,#,#,#,#,#,#,#,#,#,#,#,#,#,#,#,#,#,#,#,#,#,#,#,#,#,#,#,#,
#,#,#,#,#,#,#,#,#,#,#,#,#,#,#,#, , , , ,#,#,#,#,#,#,#,#,#,#,#,#,#,#,#,#,#,#,#,#,#,#,#,#,#,#,#,#,#,#,
#,#,#,#,#,#,#,#,#,#,#,#,#,#,#,#,#, , ,#,#,#,#,#,#,#,#,#,#,#,#,#,#,#,#,#,#,#,#,#,#,#,#,#,#,#,#,#,#,#,
#,#,#,#,#,#,#,#,#,#,#,#,#,#,#,#,#,#,#,#,#,#,#,#,#,#,#,#,#,#,#,#,#,#,#,#,#,#,#,#,#,#,#,#,#,#,#,#,#,#,
#,#,#,#,#,#,#,#,#,#,#,#,#,#,#,#,#,#,#,#,#,#,#,#,#,#,#,#,#,#,#,#,#,#,#,#,#,#,#,#,#,#,#,#,#,#,#,#,#,#,
