#,#,#,#,#,#,#,#,#,#,#,#,#,#,#,#,#,#,#,#,#,#,#,#,#,#,#,#,#,#,#,#,#,#,#,#,#,#,#,#,#,#,#,#,#,#,#,#,#,#,
#,#,#,#,#,#,#,#,#,#,#,#,#,#,#,#,#,#,#,#,#,#,#,#,#,#,#,#,#,#,#,#,#, , , , , , , , ,#,#,#,#,#,#,#,#,#,
#,#,#, , , ,#,#,#,#,#,#,#,#,#,#,#,#, , ,#,#,#,#,#,#,#,#,#,#,#,#, , , , , , , , , , ,#,#,#,#,#,#,#,#,
#,#, , , , , , ,#,#,#,#,#,#,#,#,#, , , , , , , , ,#,#,#,#,#,#,#, , , , ,#,#,#, , , ,#,#,#,#,#,#,#,#,
#,#, , ,#,#, , , ,#,#,#,#,#,#,#, , , ,#,#, , , , , ,#,#,#,#,#,#,#, , ,#,#,#,#,#, , ,#,#,#,#,#,#,#,#,
#,#,#,#,#,#,#, , , ,#,#,#,#, , , , ,#,#,#,#, , , , ,#,#,#,#,#,#,#, , ,#,#,#,#,#, , ,#,#,#,#,#,#,#,#,
#,#,#,#,#,#,#, , , , ,#,#, , , ,#,#,#,#,#,#, , , ,#,#,#,#,#,#,#,#, , , ,#,#,#,#, , ,#,#,#,#,#,#,#,#,
#,#,#,#,#,#,#,#, , , , , , , ,#,#,#,#,#,#,#, , ,#,#,#,#,#,#,#,#,#, , , , ,#,#, , ,#,#,#,#,#,#,#,#,#,
#,#,#,#,#,#,#,#,#, , , , , , ,#,#,#,#,#,#,#, , ,#,#,#,#,#,#,#,#, , , , , , , , , ,#,#,#,#,#,#,#,#,#,
#,#,#,#,#,#,#,#,#,#, , , , , , ,#,#,#,#,#,#, , ,#,#,#,#,#,#,#,#, , , , , , , , , , ,#,#,#,#,#,#,#,#,
#,#,#,#,#,#,#,#,#,#, , , , , , , ,#,#,#,#, , , , ,#,#,#,#,#,#,#, , , , , , , , , , , ,#,#,#,#,#,#,#,
#,#,#,#,#,#,#,#,#, , , , , , , , , , , , , , , , , ,#,#,#,#,#,#, , , , , , , ,#,#,#, , ,#,#,#,#,#,#,
#,#,#,#,#,#,#,#, , , , , ,#,#,#, , , , , , , , , , , ,#,#,#,#,#,#, , , , , ,#,#,#,#,#, , ,#,#,#,#,#,
#,#,#,#,#, , , , , , , ,#,#,#,#,#,#,#,#,#,#, , , , , , ,#,#,#,#,#,#, , , , ,#,#,#,#,#,#, , ,#,#,#,#,
#,#,#,#, , , , , , ,#,#,#,#,#,#,#,#,#,#,#,#,#,#,#,#, , , ,#,#,#,#,#,#, , , ,#,#,#,#,#,#, , ,#,#,#,#,
#,#,#, , , , , , ,#,#,#,#,#,#,#,#,#,#,#,#,#,#,#,#,#,#, , , ,#,#,#,#,#,#, , ,#,#,#,#,#, , , ,#,#,#,#,
#,#,#, , , , , , ,#,#,#,#,#,#,#,#,#,#,#,#,#,#,#,#,#,#,#, , , ,#,#,#,#,#, , ,#,#,#,#,#, , ,#,#,#,#,#,
#,#,#, , , , , , , ,#,#, , ,#,#,#,#,#,#,#,#,#,#,#,#,#,#,#, , , ,#,#,#,#, , ,#,#,#,#, , ,#,#,#,#,#,#,
#,#, , , , , , , , , , , , , ,#,#,#,#,#,#,#,#,#,#,#,#,#,#, , , ,#,#,#,#, , , ,#,#, , ,#,#,#,#,#,#,#,
#,#, , , , , , , , , , , , , , ,#,#, , , , , , , , ,#,#,#, , , ,#,#,#,#,#, , , , , , ,#,#,#,#,#,#,#,
#,#, , , , , , , , , , , , , , , , , , , , , , , , , ,#,#, , , , ,#,#,#,#, , , , , , ,#,#,#,#,#,#,#,
#,#, , , , , ,#,#,#, , , , , , , , , , , ,#,#,#,#,#, , , , , , , , ,#,#,#, , , , , , ,#,#,#,#,#,#,#,
#,#,#, , , ,#,#,#,#,#, , , , ,#,#,#,#,#,#,#,#,#,#,#,#, , , , , , , , , , , , , , , , ,#,#,#,#,#,#,#,
#,#,#, , ,#,#,#,#,#,#,#, , ,#,#,#,#,#,#,#,#,#,#,#,#,#, , , , , , , , , , , , , , , , ,#,#,#,#,#,#,#,
#,#,#, , ,#,#,#,#,#,#,#, , , ,#,#,#, , , ,#,#,#,#,#,#, , , , , , , , , , , , , , , , , ,#,#,#,#,#,#,
#,#,#, , , ,#,#,#,#,#, , , , , , , , , , , ,#,#,#,#,#, , , , , , , , , , , ,#,#,#, , , , ,#,#,#,#,#,
#,#,#, , , ,#,#,#,#, , , , , , , ,#,#, , , , ,#,#,#, , , , , , , , , , , ,#,#,#,#,#, , , , ,#,#,#,#,
#,#,#,#, , , ,#,#, , , ,#,#,#,#,#,#,#,#, , , , , , , , , , , , , , , , ,#,#,#,#,#,#, , , , ,#,#,#,#,
#,#,#,#,#, , , , , , ,#,#,#,#,#,#,#,#,#,#, , , , , ,#,#, , , , , , , , ,#,#,#,#,#,#,#, , , ,#,#,#,#,
#,#,#,#,#, , , , , , ,#,#,#,#,#,#,#,#,#,#,#, , , ,#,#,#,#,#,#,#,#, , , ,#,#,#,#,#,#,#, , , ,#,#,#,#,
#,#,#,#, , , , , , , ,#,#,#,#,#,#,#,#,#,#,#,#,#,#,#,#,#,#,#,#,#,#,#, , , ,#,#,#,#,#,#, , ,#,#,#,#,#,
#,#,#,#, , ,#,#,#, , ,#,#,#,#,#,#,#,#,#,#,#,#,#,#,#,#,#,#,#,#,#,#,#,#, , ,#,#,#,#,#, , , ,#,#,#,#,#,
#,#,#,#, , , ,#, , , ,#,#,#,#,#,#,#,#,#,#,#,#,#,#,#,#,#,#,#,#,#,#,#,#, , , ,#,#,#, , , ,#,#,#,#,#,#,
#,#,#,#,#, , , , , , ,#,#,#,#,#,#,#,#,#,#,#,#,#,#,#,#,#,#,#,#,#,#,#,#,#, , , , , , , ,#,#,#,#,#,#,#,
#,#,#,#,#, , , , , ,#,#,#,#, , , , ,#,#,#,#,#,#,#,#,#,#,#,#,#,#,#,#,#,#, , , , , , ,#,#,#,#,#,#,#,#,
#,#,#,#,#, , , , ,#,#,#,#, , , , , , , ,#,#,#,#,#,#,#,#,#,#,#,#,#,#,#,#,#, , , , , ,#,#,#,#,#,#,#,#,
#,#,#,#, , ,#,#,#,#,#,#,#, , , , , , , , , , , ,#,#,#,#,#,#,#,#,#,#,#,#,#, , , , , ,#,#,#,#,#,#,#,#,
#,#,#, , ,#,#,#,#,#,#,#, , , , , , , , , , , , , ,#,#,#,#,#,#,#,#,#,#,#,#, , , , , ,#,#,#,#,#,#,#,#,
#,#, , ,#,#,#,#,#,#,#, , , , , , ,#,#,#,#,#, , , ,#,#,#,#,#,#,#,#,#,#,#, , , , , , ,#,#,#,#,#,#,#,#,
#, , , ,#,#,#,#,#,#, , , , , , ,#,#,#,#,#,#,#, , ,#,#,#,#,#,#,#, , , , , , , , , , ,#,#,#,#,#,#,#,#,
#, , ,#,#,#,#,#,#,#, , , , , , ,#,#,#,#,#,#,#, , ,#,#,#,#,#,#, , , , , , ,#,#,#, , , ,#,#,#,#,#,#,#,
#, , ,#,#,#,#,#,#, , , , , , , , ,#,#,#,#,#, , ,#,#,#,#,#,#,#, , , , , ,#,#,#,#,#, , , ,#,#,#,#,#,#,
#, , ,#,#,#,#, , , , , , , , , , , ,#,#,#, , , ,#,#,#,#,#,#,#, , , , , ,#,#,#,#,#, , , ,#,#,#,#,#,#,
#, , , ,#,#, , , ,#,#,#, , , , , , , , , , , , ,#,#,#,#,#,#,#,#, , , , ,#,#,#,#,#, , , ,#,#,#,#,#,#,
#,#, , , , , , ,#,#,#,#,#, , , , , , , , , , ,#,#,#,#,#,#,#,#,#,#, , , ,#,#,#,#,#, , ,#,#,#,#,#,#,#,
#,#,#, , , , , ,#,#,#,#,#,#, , , , , , , , , ,#,#,#,#,#,#,#,#,#,#,#, , , ,#,#,#, , , ,#,#,#,#,#,#,#,
#,#,#, , , , ,#,#,#,#,#,#,#,#, , , , , , , ,#,#,#,#,#,#,#,#,#,#,#,#,#, , , , , , , , ,#,#,#,#,#,#,#,
#,#,#,#, , ,#,#,#,#,#,#,#,#,#,#,#,#,#,#,#,#,#,#,#,#,#,#,#,#,#,#,#,#,#,#, , , , , , ,#,#,#,#,#,#,#,#,
#,#,#,#,#,#,#,#,#,#,#,#,#,#,#,#,#,#,#,#,#,#,#,#,#,#,#,#,#,#,#,#,#,#,#,#,#,#,#,#,#,#,#,#,#,#,#,#,#,#,
#,#,#,#,#,#,#,#,#,#,#,#,#,#,#,#,#,#,#,#,#,#,#,#,#,#,#,#,#,#,#,#,#,#,#,#,#,#,#,#,#,#,#,#,#,#,#,#,#,#,
