#,#,#,#,#,#,#,#,#,#,#,#,#,#,#,#,#,#,#,#,#,#,#,#,#,#,#,#,#,#,#,#,#,#,#,#,#,#,#,#,#,#,#,#,#,#,#,#,#,#,
#,#,#,#,#,#,#,#,#,#,#,#,#,#,#,#,#,#,#,#,#,#,#,#,#,#,#,#,#,#,#,#,#,#,#,#,#,#,#,#,#,#,#,#,#,#,#,#,#,#,
#,#,#,#,#,#,#,#,#, , , ,#,#,#,#,#,#,#,#,#,#,#,#,#,#,#,#,#,#,#,#,#,#,#,#,#,#, , , , , , ,#,#,#,#,#,#,
#,#,#,#,#,#,#,#, , , , , ,#,#,#,#,#,#,#,#,#,#,#,#,#,#,#,#,#,#,#,#,#, , , , , , , , , , , ,#,#,#,#,#,
#,#,#,#,#,#, , , , , , , ,#,#,#,#,#,#,#,#,#,#,#,#,#,#,#,#,#,#,#,#, , , , , , ,#,#,#, , , , ,#,#,#,#,
#,#,#,#,#, , , ,#,#, , , , ,#,#,#,#,#,#,#,#,#,#, , , ,#,#,#,#,#, , , , , , ,#,#,#,#,#, , , , ,#,#,#,
#,#,#,#,#, , ,#,#,#,#, , , , , , , ,#,#,#,#, , , , , , ,#,#,#, , , , , , ,#,#,#,#,#,#, , , , , ,#,#,
#,#,#,#,#, , ,#,#,#,#,#, , , , , , , , , , , , , , , , , , , , , , , , , ,#,#,#,#,#,#, , , , , ,#,#,
#,#,#,#, , , ,#,#,#,#,#, , , , , , , , , , , , , ,#,#,#, , , , , , , , , ,#,#,#,#,#, , , , , ,#,#,#,
#,#,#,#, , , ,#,#,#,#,#, , , , , , , , , , , , ,#,#,#,#,#, , , , , , , , , ,#,#,#, , , , , ,#,#,#,#,
#,#,#,#,#, , , ,#,#,#, , , , ,#,#,#,#,#,#, , , ,#,#,#,#,#,#, , , , , , , , , , , , , , , ,#,#,#,#,#,
#,#,#,#,#,#, , , , , , , , ,#,#,#,#,#,#,#,#, , ,#,#,#,#,#,#, , , ,#,#,#,#,#, , , , , , ,#,#,#,#,#,#,
#,#,#,#,#,#, , , , , , , ,#,#,#,#,#,#,#,#,#,#, ,#,#,#,#,#, , , ,#,#,#,#,#,#,#, , , , , ,#,#,#,#,#,#,
#,#,#,#,#,#,#, , , , , ,#,#,#,#,#,#,#,#,#,#,#, , ,#,#,#, , , ,#,#,#,#,#,#,#,#,#, , , , , ,#,#,#,#,#,
#,#,#,#,#,#,#, , , , , ,#,#,#,#,#,#,#,#,#,#,#, , , , , , , ,#,#,#,#,#,#,#,#,#,#, , ,#,#,#,#,#,#,#,#,
#,#,#,#,#,#,#, , , , ,#,#,#,#,#,#,#,#,#,#,#,#, , , , , , ,#,#,#,#,#,#,#,#,#,#,#, , ,#,#,#,#,#,#,#,#,
#,#,#,#,#,#,#, , , , ,#,#,#,#,#,#,#,#,#,#,#,#,#, , , , ,#,#,#,#,#,#,#,#,#,#,#,#, , ,#,#,#,#,#,#,#,#,
#,#,#,#,#,#,#, , , , ,#,#,#,#,#,#,#,#,#,#,#,#,#, , , , ,#,#,#,#,#,#,#,#,#,#,#, , , ,#,#,#,#,#,#,#,#,
#,#,#,#,#,#,#, , , , ,#,#,#,#,#,#,#,#,#,#,#,#,#, , , , ,#,#,#,#,#,#,#,#,#,#, , , , , , ,#,#,#,#,#,#,
#,#,#,#,#,#, , , , , ,#,#,#,#,#,#,#,#,#,#,#,#, , , , ,#,#,#,#,#,#,#,#,#,#, , , , , , , , ,#,#,#,#,#,
#,#,#,#,#, , , , , , ,#,#,#,#,#,#,#,#,#,#,#, , , , , ,#,#,#,#,#,#,#,#,#, , , , ,#,#, , , , ,#,#,#,#,
#,#,#,#, , ,#,#,#, , , ,#,#,#,#,#,#,#,#,#, , , , , ,#,#,#,#,#,#,#,#,#,#, , , ,#,#,#,#, , , , ,#,#,#,
#,#,#, , ,#,#,#,#,#, , ,#,#,#,#,#,#,#,#, , , , , , ,#,#,#,#,#,#,#,#,#,#, , ,#,#,#,#,#,#, , , , ,#,#,
#,#, , , ,#,#,#,#,#,#, , ,#,#,#,#,#,#, , , ,#,#, , , ,#,#,#,#,#,#,#,#, , , ,#,#,#,#,#,#, , , , ,#,#,
#,#, , , ,#,#,#,#,#,#, , , , , , , , , , ,#,#,#,#, , , ,#,#,#,#,#,#,#, , , , ,#,#,#,#,#, , , ,#,#,#,
#,#, , , , ,#,#,#,#, , , , , , , , , , ,#,#,#,#,#,#, , , ,#,#,#,#,#,#, , , , , ,#,#,#, , , , ,#,#,#,
#,#,#, , , , , , , , , , , , , , , , ,#,#,#,#,#,#,#, , , ,#,#,#,#,#,#,#, , , , , , , , , , , ,#,#,#,
#,#,#,#, , , , , , , , , ,#,#, , , , ,#,#,#,#,#,#,#, , , ,#,#,#,#,#,#,#,#, , , , , , , , , ,#,#,#,#,
#,#,#,#,#, , ,#,#,#,#,#,#,#,#,#,#, , ,#,#,#,#,#,#, , , ,#,#,#,#,#,#,#,#,#,#, , , , , ,#,#,#,#,#,#,#,
#,#,#,#,#,#,#,#,#,#,#,#,#,#,#,#,#,#, , ,#,#,#,#,#, , ,#,#,#,#,#,#,#,#,#,#,#,#, , ,#,#,#,#,#,#,#,#,#,
#,#,#,#,#,#,#,#,#,#,#,#,#,#,#,#,#,#,#, , ,#,#,#, , , ,#,#,#,#,#,#,#,#,#,#,#,#,#,#,#,#,#,#,#,#,#,#,#,
#,#,#,#,#,#,#,#,#,#,#,#,#,#,#,#,#,#,#, , , , , , , ,#,#,#,#,#,#,#,#,#,#,#,#,#,#,#,#,#,#,#,#,#,#,#,#,
#,#,#,#,#,#,#,#,#,#,#,#,#,#,#,#,#,#,#, , , , , , ,#,#,#,#,#,#,#,#,#,#,#,#,#,#,#,#,#,#,#,#,#,#,#,#,#,
#,#,#,#,#,#,#,#,#,#,#,#,#,#,#,#,#,#, , , , , , ,#,#,#,#,#,#,#,#,#,#,#,#,#,#,#,#,#,#,#,#,#,#,#,#,#,#,
#,#,#, , ,#,#,#,#,#,#,#,#,#,#,#,#,#, , , , , ,#,#,#,#,#,#,#,#,#,#,#,#,#,#,#,#,#,#,#,#,#,#,#,#,#,#,#,
#,#, , , , , , ,#,#,#,#,#,#,#,#,#, , , , , , ,#,#,#,#,#,#,#,#, , , , ,#,#,#,#,#,#,#,#,#,#,#,#,#,#,#,
#,#, , , , , , , ,#,#,#,#,#,#,#, , , , , , ,#,#,#,#,#, , , , , , , , , ,#,#,#, , , , , , ,#,#,#,#,#,
#, , , ,#,#, , , , ,#,#,#,#, , , , , , , ,#,#,#,#,#, , , , , , , , , , , , , , , , , , , , , ,#,#,#,
#, , ,#,#,#,#, , , , , , , , , , , , , , ,#,#,#,#, , , , , , , , , , , , , , , ,#,#,#,#,#, , , ,#,#,
#, , ,#,#,#,#,#, , , , , , , ,#,#,#, , , , ,#,#, , , , ,#,#,#,#,#, , , , , , ,#,#,#,#,#,#,#, , ,#,#,
#, , ,#,#,#,#,#, , , , , , ,#,#,#,#,#, , , , , , , , ,#,#,#,#,#,#,#, , , , , ,#,#,#,#,#,#,#, , ,#,#,
#, , , ,#,#,#, , , , , , ,#,#,#,#,#,#,#, , , , , , , ,#,#,#,#,#,#,#, , , , , , ,#,#,#,#,#,#, , ,#,#,
#, , , , , , , , , , , , ,#,#,#,#,#,#,#,#, , , , , , , ,#,#,#,#,#, , , , , , , , , ,#,#,#, , ,#,#,#,
#,#, , , , , , , , , , , , ,#,#,#,#,#,#,#,#, , , , , , ,#,#,#,#, , , , , , , , , , , , , , ,#,#,#,#,
#,#,#, , , , , , , ,#,#, , , ,#,#,#,#,#,#,#,#, , , , , , ,#,#, , ,#,#, , , , ,#,#, , , , ,#,#,#,#,#,
#,#,#,#,#,#,#,#,#,#,#,#,#, , , ,#,#,#,#,#,#,#,#,#, , , , , , , ,#,#,#,#,#,#,#,#,#,#,#,#,#,#,#,#,#,#,
#,#,#,#,#,#,#,#,#,#,#,#,#,#, , ,#,#,#,#,#,#,#,#,#,#, , , , , , ,#,#,#,#,#,#,#,#,#,#,#,#,#,#,#,#,#,#,
#,#,#,#,#,#,#,#,#,#,#,#,#,#,#,#,#,#,#,#,#,#,#,#,#,#,#, , , , ,#,#,#,#,#,#,#,#,#,#,#,#,#,#,#,#,#,#,#,
#,#,#,#,#,#,#,#,#,#,#,#,#,#,#,#,#,#,#,#,#,#,#,#,#,#,#,#,#,#,#,#,#,#,#,#,#,#,#,#,#,#,#,#,#,#,#,#,#,#,
#,#,#,#,#,#,#,#,#,#,#,#,#,#,#,#,#,#,#,#,#,#,#,#,#,#,#,#,#,#,#,#,#,#,#,#,#,#,#,#,#,#,#,#,#,#,#,#,#,#,
