#,#,#,#,#,#,#,#,#,#,#,#,#,#,#,#,#,#,#,#,#,#,#,#,#,#,#,#,#,#,#,#,#,#,#,#,#,#,#,#,#,#,#,#,#,#,#,#,#,#,
#,#,#,#,#,#,#,#,#, , , , , ,#,#,#,#,#,#,#,#,#,#,#,#,#,#,#,#,#,#,#,#,#,#,#,#,#,#,#,#,#,#,#,#,#,#,#,#,
#,#,#,#,#,#,#,#, , , , , , ,#,#,#,#,#,#,#,#,#,#,#,#, , , , , ,#,#,#,#,#,#,#,#,#,#,#,#,#,#,#,#,#,#,#,
#,#,#,#,#,#,#, , , ,#,#,#,#,#,#,#,#,#,#,#,#,#,#,#, , , , , , , , ,#,#,#,#,#, , , ,#,#,#,#,#,#,#,#,#,
#,#,#,#,#,#, , , ,#,#,#,#,#,#,#,#,#,#,#,#,#,#,#,#, ,#,#,#,#, , , , ,#,#,#, , , , , ,#,#,#,#,#,#,#,#,
#,#,#,#,#, , , , ,#,#,#,#,#,#,#,#,#,#,#,#,#,#,#,#,#,#,#,#,#,#, , , , , , , , , , , , , , , ,#,#,#,#,
#,#,#, , , , , , ,#,#,#,#,#, , , , ,#,#,#,#,#,#,#,#,#,#,#,#,#, , , , , , , , , ,#,#, , , , , ,#,#,#,
#,#, , , , , , , , ,#,#,#, , , , , , , , ,#,#,#,#,#,#,#,#,#,#, , , , , , , , ,#,#,#,#, , , , , ,#,#,
#, , , , , , , , , , , , , , , , , , , , , , , ,#,#,#,#,#,#, , , , , , , , , ,#,#,#,#,#, , , , ,#,#,
#, , , , , , ,#,#, , , , , , , , , ,#,#,#, , , , ,#,#,#, , , , , , , , , , , ,#,#,#,#,#, , , , ,#,#,
#, , , ,#,#,#,#,#,#, , , ,#,#,#,#,#,#,#,#,#, , , , , , , , , ,#,#, , , , , , ,#,#,#,#,#, , , , ,#,#,
#, , ,#,#,#,#,#,#, , , ,#,#,#,#,#,#,#,#,#,#, , , , , , , , ,#,#,#,#,#,#,#, , , ,#,#,#, , , , ,#,#,#,
#, , ,#,#,#,#,#, , , , ,#,#,#,#,#,#,#,#,#,#, , , , , , , ,#,#,#,#,#,#,#,#,#, , , , , , , , ,#,#,#,#,
#, , ,#,#,#,#, , , , , ,#,#,#,#,#,#,#,#,#, , , , , , , , ,#,#,#,#,#,#,#,#,#, , , , , , , ,#,#,#,#,#,
#, , ,#,#,#,#, , , , , ,#,#,#,#,#,#,#,#,#, , , , , , , , ,#,#,#,#,#,#,#,#,#,#, , , ,#,#,#,#,#,#,#,#,
#, , ,#,#,#,#, , , , , ,#,#,#,#,#,#,#,#, , , , , , , , , ,#,#,#,#,#,#,#,#,#,#,#,#,#,#,#,#,#,#,#,#,#,
#,#, , ,#,#,#, , , , ,#,#,#,#,#,#,#,#, , , ,#,#, , , , ,#,#,#,#,#,#,#,#,#,#,#,#,#,#,#,#,#,#,#,#,#,#,
#,#, , , , , , , , ,#,#,#,#,#,#,#,#, , , ,#,#,#,#, , , ,#,#,#,#,#,#,#,#,#,#,#,#,#,#,#,#,#,#,#,#,#,#,
#,#,#, , , , , , ,#,#,#,#,#,#,#,#, , ,#,#,#,#,#,#, , ,#,#,#,#,#,#,#,#,#,#,#,#,#,#,#,#,#,#,#,#,#,#,#,
#,#,#, , , , , , ,#,#,#,#,#,#,#, , ,#,#,#,#,#,#,#, , ,#,#,#,#,#,#,#,#,#,#,#,#, , ,#,#,#,#,#,#,#,#,#,
#,#,#, , , , , , ,#,#,#,#,#,#,#, , ,#,#,#,#,#,#,#, , ,#,#,#,#,#,#,#,#,#,#,#, , , , ,#,#,#,#,#,#,#,#,
#,#,#, , , , , , ,#,#,#,#,#,#,#, , , ,#,#,#,#,#, , ,#,#,#,#,#,#,#,#,#,#,#, , , , , , , ,#,#,#,#,#,#,
#,#,#,#, , , , , ,#,#,#,#,#,#,#, , , , ,#,#,#, , , ,#,#,#,#,#,#,#,#,#,#, , , ,#,#, , , , , , ,#,#,#,
#,#,#,#, , , , , ,#,#,#,#,#,#,#,#, , , , , , , , ,#,#,#,#,#,#,#,#,#,#,#, , ,#,#,#,#, , , , , , ,#,#,
#,#,#,#, , , , , , ,#,#,#,#,#,#,#,#, , , , , , ,#,#,#,#,#,#,#,#,#,#,#, , , ,#,#,#,#,#, , , , , ,#,#,
#,#,#, , , , , , , , , , ,#,#,#,#,#,#, , , , ,#,#,#,#,#,#,#,#,#,#,#,#, , , ,#,#,#,#,#, , , , , ,#,#,
#,#, , , , ,#,#,#, , , , , ,#,#,#,#,#,#, , ,#,#,#,#,#,#,#,#,#,#,#,#,#, , , ,#,#,#,#,#,#, , , , ,#,#,
#,#, , , ,#,#,#,#,#, , , , ,#,#,#,#,#,#,#,#,#,#,#,#,#,#,#,#,#,#,#,#,#, , , ,#,#,#,#,#,#, , , ,#,#,#,
#,#, , , ,#,#,#,#,#,#, , , ,#,#,#,#,#,#,#,#,#,#,#,#, , ,#,#,#,#,#,#,#,#, , ,#,#,#,#,#, , , ,#,#,#,#,
#,#, , , ,#,#,#,#,#,#, , ,#,#,#,#,#,#,#,#,#,#,#,#, , , , ,#,#,#,#,#,#,#,#, , ,#,#,#, , , ,#,#,#,#,#,
#,#, , , , ,#,#,#,#, , , ,#,#,#,#,#,#,#,#,#,#,#,#, , , , ,#,#,#,#,#,#,#,#,#, , , , , , ,#,#,#,#,#,#,
#,#,#, , , , ,#,#, , , ,#,#,#,#,#,#,#,#,#,#,#,#,#,#, , ,#,#,#,#,#,#,#,#,#,#, , , , , , ,#,#,#,#,#,#,
#,#,#,#, , , , , , , ,#,#,#,#,#,#,#,#,#,#,#,#,#,#,#, , ,#,#,#,#,#,#,#,#,#, , , , , , , ,#,#,#,#,#,#,
#,#,#,#,#, , , , , , ,#,#,#,#,#,#,#,#,#,#,#,#,#,#,#, , ,#,#,#,#,#,#,#,#, , , ,#,#,#, , ,#,#,#,#,#,#,
#,#,#,#,#,#, , , , , ,#,#,#,#,#,#,#,#,#,#, , , , , , , ,#,#,#,#,#, , , , , , ,#,#,#, , ,#,#,#,#,#,#,
#,#,#,#,#,#,#, , , , ,#,#,#,#,#,#,#,#,#, , , , , , , , , ,#,#,#, , , , , , , ,#,#, , , , ,#,#,#,#,#,
#,#,#,#,#,#,#, , , , ,#,#,#,#,#,#,#,#, , , ,#,#,#,#,#, , , , , , , , , , , , ,#,#, , , , , , ,#,#,#,
#,#,#,#,#,#, , , , , , ,#,#,#,#,#,#, , , ,#,#,#,#,#,#,#, , , , , , , , , , , ,#,#,#, , , , , , ,#,#,
#,#,#,#,#, , , , , , , , ,#,#, , , , , , ,#,#,#,#,#,#,#, , , , , , , , , , ,#,#,#,#,#, , , , , , ,#,
#,#,#,#, , , , ,#,#,#, , , , , , ,#,#, , ,#,#,#,#,#,#,#, , , , , , , , , ,#,#,#,#,#,#, , , , , , ,#,
#,#,#,#, , , ,#,#,#,#,#, , , , ,#,#,#,#, , ,#,#,#,#,#, , , , , , , , , ,#,#,#,#,#,#,#, , , , , ,#,#,
#,#,#,#, , ,#,#,#,#,#,#, , , ,#,#,#,#,#, , , , , , , , , , , , , , , , ,#,#,#,#,#,#,#, , , ,#,#,#,#,
#,#,#,#, , ,#,#,#,#,#,#, , , ,#,#,#,#,#, , , , , , , , , , , , , , , , , ,#,#,#,#,#, , , ,#,#,#,#,#,
#,#,#,#, , ,#,#,#,#,#,#, , , ,#,#,#,#, , , , , , , , , ,#,#,#,#,#,#,#, , , , ,#,#, , , , ,#,#,#,#,#,
#,#,#,#, , ,#,#,#,#,#,#, , , ,#,#,#,#, ,#,#,#,#, , , ,#,#,#,#,#,#,#,#,#, , , , , , , , , ,#,#,#,#,#,
#,#,#,#, , , ,#,#,#,#,#, , ,#,#,#,#,#,#,#,#,#,#,#,#,#,#,#,#,#,#,#,#,#,#,#,#,#, , , , , ,#,#,#,#,#,#,
#,#,#,#, , , ,#,#,#,#,#,#,#,#,#,#,#,#,#,#,#,#,#,#,#,#,#,#,#,#,#,#,#,#,#,#,#,#,#, , , ,#,#,#,#,#,#,#,
#,#,#,#,#, ,#,#,#,#,#,#,#,#,#,#,#,#,#,#,#,#,#,#,#,#,#,#,#,#,#,#,#,#,#,#,#,#,#,#,#,#,#,#,#,#,#,#,#,#,
#,#,#,#,#,#,#,#,#,#,#,#,#,#,#,#,#,#,#,#,#,#,#,#,#,#,#,#,#,#,#,#,#,#,#,#,#,#,#,#,#,#,#,#,#,#,#,#,#,#,
#,#,#,#,#,#,#,#,#,#,#,#,#,#,#,#,#,#,#,#,#,#,#,#,#,#,#,#,#,#,#,#,#,#,#,#,#,#,#,#,#,#,#,#,#,#,#,#,#,#,
