#,#,#,#,#,#,#,#,#,#,#,#,#,#,#,#,#,#,#,#,#,#,#,#,#,#,#,#,#,#,#,#,#,#,#,#,#,#,#,#,#,#,#,#,#,#,#,#,#,#,
#,#,#,#,#, , , ,#,#,#,#,#,#,#,#,#,#,#,#,#,#,#,#,#,#,#,#,#,#,#,#,#,#,#, , , , , , , , , ,#,#,#,#,#,#,
#,#,#,#, , , , , ,#,#,#,#,#,#,#,#,#,#,#,#,#,#,#,#,#,#,#,#,#,#,#,#,#, , , , , , , , , , , ,#,#,#,#,#,
#,#,#, , ,#,#,#, , ,#,#,#,#,#,#,#,#,#,#,#,#, , , , ,#,#,#,#,#,#,#, , , , ,#,#,#,#, , , , ,#,#,#,#,#,
#,#, , ,#,#,#,#,#, , , , ,#,#,#,#,#,#, , , , , , , , ,#,#,#, , , , , , ,#,#,#,#,#,#, , , ,#,#,#,#,#,
#,#, , ,#,#,#,#,#,#, , , , ,#,#,#, , , , , , ,#,#, , , , , , , , , , , ,#,#,#,#,#,#, , , ,#,#,#,#,#,
#,#, , ,#,#,#,#,#,#,#, , , , , , , , , ,#,#,#,#,#,#, , , , ,#, , , , , , ,#,#,#,#,#, , , ,#,#,#,#,#,
#,#, , ,#,#,#,#,#,#,#, , , , , , , , ,#,#,#,#,#,#,#,#, , , ,#, , , , , , , ,#,#,#, , , , ,#,#,#,#,#,
#,#, , , ,#,#,#,#,#, , , , , , , , , ,#,#,#,#,#,#,#,#, , , , , , ,#,#, , , , , , , , , ,#,#,#,#,#,#,
#,#,#, , , ,#,#,#, , , , , , , , , , ,#,#,#,#,#,#,#, , , , , ,#,#,#,#,#, , , , , , , , ,#,#,#,#,#,#,
#,#,#,#, , , , , , ,#,#, , , , , , , , ,#,#,#,#,#, , , , , ,#,#,#,#,#,#,#, , , , , , ,#,#,#,#,#,#,#,
#,#,#,#,#, , , , ,#,#,#,#, , , , , , , , , , , , , , , , , ,#,#,#,#,#,#,#, , , , , , ,#,#,#,#,#,#,#,
#,#,#,#,#,#, , , ,#,#,#,#,#, , , , , , , , , , , , , , , , ,#,#,#,#,#,#,#, , , , , , , ,#,#,#,#,#,#,
#,#,#,#,#,#, , , , ,#,#,#,#,#,#,#,#, , , , , , , , , , , , , ,#,#,#,#,#,#, , , , , , , , ,#,#,#,#,#,
#,#,#,#,#,#, , , , , ,#,#,#,#,#,#,#,#, , , , , ,#,#,#, , , , ,#,#,#,#,#,#, , , , , , , , , ,#,#,#,#,
#,#,#,#,#,#, , , , , , ,#,#,#,#,#,#,#, , , , ,#,#,#,#,#,#,#,#,#,#,#,#,#, , , , , ,#,#, , , ,#,#,#,#,
#,#,#,#,#,#, , , , , , ,#,#,#,#,#,#,#,#, , ,#,#,#,#,#,#,#,#,#,#,#,#,#, , , , , ,#,#,#,#, , ,#,#,#,#,
#,#,#,#,#, , , , , , ,#,#,#,#,#,#,#,#,#,#,#,#,#,#,#,#,#,#,#,#,#,#,#,#, , , , ,#,#,#,#,#, , ,#,#,#,#,
#,#,#,#, , , , , , , ,#,#,#,#,#,#,#,#,#,#,#,#,#,#,#,#,#,#,#,#,#,#,#,#, , , ,#,#,#,#,#,#,#, , ,#,#,#,
#,#,#, , , ,#,#,#, , , ,#,#,#,#,#,#,#,#,#,#,#,#,#,#,#,#,#,#,#,#,#,#, , , ,#,#,#,#,#,#,#,#, , ,#,#,#,
#,#, , , ,#,#,#,#,#, , ,#,#,#,#,#,#,#,#,#,#,#, , , , , ,#,#,#,#,#, , , , ,#,#,#,#,#,#,#, , , ,#,#,#,
#,#, , ,#,#,#,#,#,#,#, , ,#,#,#,#,#,#,#, , , , , , , , , ,#,#, , , , , , ,#,#,#,#,#,#, , , , , ,#,#,
#,#, , ,#,#,#,#,#,#,#,#, , ,#,#,#,#,#, , , , , ,#,#,#, , , , , , , , , , , , , , , , , , , , , ,#,#,
#,#, , , ,#,#,#,#,#,#,#, , ,#,#,#,#,#, , , , ,#,#,#,#,#,#, , , , , , , , , , , , , , , , , , ,#,#,#,
#,#, , , , ,#,#,#,#,#, , , ,#,#,#,#,#,#, , , ,#,#,#,#,#,#,#, , , , , , , , , , , , , , ,#,#,#,#,#,#,
#,#,#, , , , , ,#,#, , , ,#,#,#,#,#,#,#,#, , ,#,#,#,#,#,#,#, , , , , , , , , , , , , ,#,#,#,#,#,#,#,
#,#,#,#,#,#, , , , , , ,#,#,#,#,#,#,#,#,#, , , ,#,#,#,#,#,#, , , , , , , , ,#,#,#,#,#,#,#,#,#,#,#,#,
#,#,#,#,#,#,#,#,#, , ,#,#,#,#,#,#,#,#,#, , , , , ,#,#,#,#, , ,#,#,#,#,#,#,#,#,#,#,#,#,#,#,#,#,#,#,#,
#,#,#,#,#,#,#,#,#,#,#,#,#,#,#,#,#, , , , , , , , , ,#,#, , ,#,#,#,#,#,#,#,#,#,#,#,#,#,#,#,#,#,#,#,#,
#,#,#,#,#,#,#,#,#,#,#,#,#,#,#,#, , , , , , , , , , ,#,#, , ,#,#,#,#,#,#,#,#,#,#,#,#,#,#,#,#,#,#,#,#,
#,#,#, , , ,#,#,#,#,#,#,#,#,#,#, , , , , , , , , ,#,#,#, , ,#,#,#,#,#,#,#,#,#,#,#,#,#,#,#,#,#,#,#,#,
#,#,#, , , ,#,#,#,#,#,#,#,#,#,#, , , , , , , , , ,#,#,#,#, , ,#,#,#,#,#,#,#,#,#,#,#,#,#,#,#,#,#,#,#,
#,#,#, , , ,#,#,#,#,#,#,#,#,#,#, , , , ,#,#,#,#, , ,#,#,#, , , , ,#,#,#,#,#,#,#,#,#,#,#,#,#,#,#,#,#,
#,#,#, , , ,#,#,#,#,#,#,#,#,#,#, , , ,#,#,#,#,#,#, , ,#, , , , , , ,#,#,#,#,#,#,#,#,#, , ,#,#,#,#,#,
#,#, , , , ,#,#,#,#,#,#,#,#,#,#, , , ,#,#,#,#,#,#,#, , , , , , , , , ,#,#,#,#, , , , , , , ,#,#,#,#,
#,#, , , , , ,#,#,#,#,#,#,#,#, , , , , ,#,#,#,#,#,#, , , , , , , , , , ,#,#, , , , , , , , , ,#,#,#,
#, , , , , , , ,#,#,#,#,#,#, , , , , , , , , , , , , , , , , , , , , , , , , , , , ,#,#,#, , ,#,#,#,
#, , , ,#,#, , , ,#,#,#, , , , , , , , , , , , , , , , , , ,#,#, , , , , , , , , ,#,#,#,#,#, , ,#,#,
#, , ,#,#,#,#, , , , , , , ,#,#,#,#,#, , , , , , , , , ,#,#,#,#,#, , , , , , , ,#,#,#,#,#,#, , ,#,#,
#, , ,#,#,#,#, , , , , , ,#,#,#,#,#,#,#, , , , , , ,#,#,#,#,#,#,#,#,#, , , , , ,#,#,#,#,#,#, , ,#,#,
#, , ,#,#,#,#, , , , , ,#,#,#,#,#,#,#,#,#, , , , ,#,#,#,#,#,#,#,#,#,#,#, , , , , ,#,#,#,#, , ,#,#,#,
#, , , ,#,#, , , , , , ,#,#,#,#,#,#,#,#,#, , , ,#,#,#,#,#,#,#,#,#,#,#,#, , , , , , , , , , , ,#,#,#,
#, , , , , , , , , , , , ,#,#,#,#,#,#,#, , , , ,#,#,#,#,#,#,#,#,#,#,#, , , ,#,#,#, , , , , ,#,#,#,#,
#, , , , , , ,#,#,#, , , , , ,#,#, , , , , , , ,#,#,#,#,#,#,#,#,#, , , , ,#,#,#,#,#, , , ,#,#,#,#,#,
#,#, , , , ,#,#,#,#,#, , , , , , , , , , , , ,#,#,#,#, , , , , , , , , ,#,#,#,#,#,#,#,#,#,#,#,#,#,#,
#,#,#,#,#,#,#,#,#,#,#,#, , , , , , ,#,#,#,#,#,#,#,#, , , , , , , , , ,#,#,#,#,#,#,#,#,#,#,#,#,#,#,#,
#,#,#,#,#,#,#,#,#,#,#,#,#, , , , ,#,#,#,#,#,#,#,#,#,#, , , , , , , ,#,#,#,#,#,#,#,#,#,#,#,#,#,#,#,#,
#,#,#,#,#,#,#,#,#,#,#,#,#,#,#,#,#,#,#,#,#,#,#,#,#,#,#,#,#,#,#,#,#,#,#,#,#,#,#,#,#,#,#,#,#,#,#,#,#,#,
#,#,#,#,#,#,#,#,#,#,#,#,#,#,#,#,#,#,#,#,#,#,#,#,#,#,#,#,#,#,#,#,#,#,#,#,#,#,#,#,#,#,#,#,#,#,#,#,#,#,
#,#,#,#,#,#,#,#,#,#,#,#,#,#,#,#,#,#,#,#,#,#,#,#,#,#,#,#,#,#,#,#,#,#,#,#,#,#,#,#,#,#,#,#,#,#,#,#,#,#,
