#,#,#,#,#,#,#,#,#,#,#,#,#,#,#,#,#,#,#,#,#,#,#,#,#,#,#,#,#,#,#,#,#,#,#,#,#,#,#,#,#,#,#,#,#,#,#,#,#,#,
#,#,#,#,#,#,#,#,#,#,#,#,#,#,#,#,#,#,#,#,#,#,#,#,#,#,#,#,#,#,#,#,#,#,#,#, , , , ,#,#,#,#,#,#,#,#,#,#,
#, , , ,#,#,#,#,#,#,#,#,#,#,#,#,#,#,#,#,#,#,#,#,#,#,#,#,#,#,#,#,#,#,#, , , , , , ,#,#,#,#,#,#,#,#,#,
#, , , ,#,#,#,#,#,#,#,#,#,#,#,#,#,#,#,#,#,#,#,#,#,#,#,#,#,#,#,#,#,#, , ,#,#,#, , , ,#,#,#,#,#,#,#,#,
#, , ,#,#,#,#,#,#,#,#,#,#,#,#,#,#,#,#,#,#,#,#,#,#,#,#,#,#,#,#,#,#, , ,#,#,#,#,#, , ,#,#,#,#,#,#,#,#,
#, , ,#,#,#,#,#,#,#,#,#,#,#,#,#,#,#,#,#,#,#,#,#,#,#,#,#,#,#,#,#, , ,#,#,#,#,#,#, , ,#,#,#,#,#,#,#,#,
#, , ,#,#,#,#,#,#,#,#,#,#,#,#,#,#,#,#,#,#,#,#,#,#,#,#,#,#,#,#, , , ,#,#,#,#,#,#, , ,#,#,#,#,#,#,#,#,
#, , , ,#,#,#, , ,#,#,#,#,#,#,#,#,#,#,#,#,#,#,#,#,#,#,#,#,#,#, , , ,#,#,#,#,#,#, , ,#,#,#,#,#,#,#,#,
#,#, , , , , , , ,#,#,#,#,#,#,#,#,#,#,#,#,#,#,#,#,#,#,#,#,#,#,#, , , ,#,#,#,#,#, , ,#,#,#,#,#,#,#,#,
#,#,#, , , , , ,#,#,#,#,#,#,#,#,#,#,#,#,#,#,#,#,#,#,#,#,#,#,#,#,#, , , , ,#,#, , ,#,#,#,#,#,#,#,#,#,
#,#,#, , , , ,#,#,#,#,#,#,#,#,#,#,#,#,#,#,#,#,#,#,#,#,#,#,#,#,#,#,#,#, , , , , , ,#,#,#,#,#,#,#,#,#,
#,#,#,#, , , ,#,#,#,#,#,#,#,#,#,#,#,#,#,#,#,#,#,#,#,#,#,#,#,#,#,#,#,#,#, , , , , , ,#,#,#,#,#,#,#,#,
#,#,#,#,#, , , ,#,#,#,#,#,#,#,#,#,#,#,#,#,#, ,#,#,#,#,#,#,#,#,#,#,#,#,#,#, , , , , ,#,#,#,#,#,#,#,#,
#,#,#,#,#,#, , , ,#,#,#,#,#,#,#,#,#,#,#,#, , , ,#,#,#,#,#,#,#,#,#,#,#,#,#, , , , , , ,#,#,#,#,#,#,#,
#,#,#,#,#,#,#, , ,#,#,#,#,#,#,#,#,#,#,#,#,#, , , , ,#,#,#,#,#,#,#,#,#,#,#,#, , , , , , ,#,#,#,#,#,#,
#,#,#,#,#,#,#, , , ,#,#,#,#,#,#,#,#,#,#,#,#,#, , , , ,#,#,#,#,#,#,#,#,#,#,#, , , , , , ,#,#,#,#,#,#,
#,#,#,#,#,#,#,#, , , ,#,#,#,#,#,#,#,#,#,#,#,#,#, , , ,#,#,#,#,#,#,#,#,#,#,#, , , , , , , ,#,#,#,#,#,
#,#,#,#,#,#,#,#,#, , , , , ,#,#,#,#,#,#,#,#,#,#, , ,#,#,#,#,#,#,#,#,#,#,#,#, , , , , , , ,#,#,#,#,#,
#,#,#,#,#,#,#,#,#, , , , , , ,#,#,#,#,#,#,#,#,#, , ,#,#,#,#,#,#,#,#,#,#,#,#, , , , , , , ,#,#,#,#,#,
#,#,#,#,#, , , , , , , , , , , ,#,#,#,#,#,#,#,#, , ,#,#,#,#,#,#,#,#,#,#,#,#, , , , , , , , ,#,#,#,#,
#,#,#, , , , , , , , , , , , , , ,#,#,#,#,#,#,#, , , ,#,#,#,#,#,#,#,#,#,#, , , , ,#,#,#, , , ,#,#,#,
#,#, , , , ,#,#,#, , , , , , , , , , , ,#,#,#, , , , , ,#,#,#,#,#,#,#, , , , , ,#,#,#,#,#, , , ,#,#,
#, , , , ,#,#,#,#,#, , , , , , , , , , , , , , , , , , , , ,#,#,#,#, , , , , ,#,#,#,#,#,#,#, , ,#,#,
#, , , ,#,#,#,#,#,#, , , , , , , , , , , , , , , , , , , , , ,#,#, , , , , , ,#,#,#,#,#,#,#, , ,#,#,
#, , , ,#,#,#,#,#, , , , ,#,#,#, , , , , , , , , , , ,#,#, , , , , , , , , , , ,#,#,#,#,#, , , ,#,#,
#,#, , , ,#,#,#, , , ,#,#,#,#,#,#, , ,#,#,#,#, , , ,#,#,#,#,#, , , , , , , , , , , ,#,#, , , , ,#,#,
#,#,#, , , , , , , ,#,#,#,#,#,#,#,#,#,#,#,#,#,#, , ,#,#,#,#,#,#, , , , , , , , , , , , , , , ,#,#,#,
#,#,#, , , , , , ,#,#,#,#,#,#,#,#,#,#,#,#,#,#,#, , ,#,#,#,#,#,#,#, , , , , , ,#,#,#,#, , , ,#,#,#,#,
#,#,#,#, , , , ,#,#,#,#,#,#,#,#,#,#,#,#,#,#,#,#, , ,#,#,#,#,#,#,#,#, , , , ,#,#,#,#,#,#,#,#,#,#,#,#,
#,#,#,#,#,#,#,#,#,#,#,#,#,#,#,#,#,#,#,#,#,#,#,#, , ,#,#,#,#,#,#,#,#, , , ,#,#,#,#,#,#,#,#,#,#,#,#,#,
#,#,#,#,#,#,#,#,#,#,#,#,#,#,#,#,#,#,#,#,#,#,#,#, , ,#,#,#,#,#,#,#,#, , , ,#,#,#,#,#,#,#,#,#,#,#,#,#,
#,#,#,#,#,#,#,#,#,#,#,#,#,#,#,#,#,#,#,#,#,#,#,#, , ,#,#,#,#,#,#,#,#, , , ,#,#,#,#,#,#,#,#,#,#,#,#,#,
#,#,#,#,#,#,#,#,#,#,#,#,#,#,#,#,#,#,#,#,#,#,#,#, , ,#,#,#,#,#,#,#, , , , , ,#,#,#,#,#,#,#,#,#,#,#,#,
#,#,#,#,#,#,#,#,#,#,#,#,#,#,#,#,#, , , ,#,#,#, , , , ,#,#, , , , , , , , , ,#,#,#,#,#,#,#,#,#,#,#,#,
#,#,#,#,#,#,#,#,#,#,#,#,#,#,#,#, , , , , , , , , , , , , , , , , , , , , , , ,#,#,#,#,#,#,#,#,#,#,#,
#,#,#,#,#,#, , ,#,#,#,#,#,#,#,#, , , , , , , , , , , , , ,#,#, , , , , , , , , ,#,#,#,#,#,#,#,#,#,#,
#,#,#, , , , , , , ,#,#,#,#,#, , , , ,#,#,#, , , , , ,#,#,#,#,#, , , , , , , , , , ,#,#,#,#,#,#,#,#,
#,#, , , , , , , , , ,#,#,#,#, , , ,#,#,#,#,#, , , ,#,#,#,#,#,#,#, , , , , , , , , , , ,#,#,#,#,#,#,
#,#, , , ,#,#,#,#, , ,#,#,#,#, , ,#,#,#,#,#,#, , ,#,#,#,#,#,#,#,#,#, , , , ,#,#, , , , , ,#,#,#,#,#,
#,#, , ,#,#,#,#,#,#, , ,#,#, , , ,#,#,#,#,#,#, , ,#,#,#,#,#,#,#,#,#, , , ,#,#,#,#,#, , , ,#,#,#,#,#,
#,#, , ,#,#,#,#,#,#, , , , , , , ,#,#,#,#,#,#, , ,#,#,#,#,#,#,#,#,#, , , ,#,#,#,#,#,#, , ,#,#,#,#,#,
#,#, , ,#,#,#,#,#,#, , , , , , , , ,#,#,#,#,#, , ,#,#,#,#,#,#,#,#, , , , ,#,#,#,#,#,#, , ,#,#,#,#,#,
#,#, , ,#,#,#,#,#, , , , , , , , , , ,#,#,#, , ,#,#,#,#,#,#,#,#,#, , , , , ,#,#,#,#, , ,#,#,#,#,#,#,
#,#, , , ,#,#,#, , , , , ,#,#,#,#, , , , , , ,#,#,#,#,#,#,#,#,#,#,#, , , , , ,#,#, , , ,#,#,#,#,#,#,
#,#,#, , , , , , , ,#,#,#,#,#,#,#,#, , , , ,#,#,#,#,#,#,#,#,#,#,#,#,#,#, , , , , , , , ,#,#,#,#,#,#,
#,#,#,#, , , , , ,#,#,#,#,#,#,#,#,#,#, , ,#,#,#,#,#,#,#,#,#,#,#,#,#,#,#,#, , , , , , ,#,#,#,#,#,#,#,
#,#,#,#,#,#, , ,#,#,#,#,#,#,#,#,#,#,#,#,#,#,#,#,#,#,#,#,#,#,#,#,#,#,#,#,#,#,#,#,#,#,#,#,#,#,#,#,#,#,
#,#,#,#,#,#,#,#,#,#,#,#,#,#,#,#,#,#,#,#,#,#,#,#,#,#,#,#,#,#,#,#,#,#,#,#,#,#,#,#,#,#,#,#,#,#,#,#,#,#,
#,#,#,#,#,#,#,#,#,#,#,#,#,#,#,#,#,#,#,#,#,#,#,#,#,#,#,#,#,#,#,#,#,#,#,#,#,#,#,#,#,#,#,#,#,#,#,#,#,#,
#,#,#,#,#,#,#,#,#,#,#,#,#,#,#,#,#,#,#,#,#,#,#,#,#,#,#,#,#,#,#,#,#,#,#,#,#,#,#,#,#,#,#,#,#,#,#,#,#,#,
