#,#,#,#,#,#,#,#,#,#,#,#,#,#,#,#,#,#,#,#,#,#,#,#,#,#,#,#,#,#,#,#,#,#,#,#,#,#,#,#,#,#,#,#,#,#,#,#,#,#,
#,#,#,#,#, , , , , , ,#,#,#,#,#,#,#,#,#,#,#,#,#,#,#,#,#,#,#,#,#,#,#,#,#,#,#, , , , , ,#,#,#,#,#,#,#,
#,#,#,#, , , , , , , , ,#,#,#,#,#,#,#,#,#,#,#, , , , ,#,#,#,#,#,#,#,#,#,#, , , , , , , ,#,#,#,#,#,#,
#,#,#, , , ,#,#,#,#,#, , ,#,#,#,#,#,#,#, , , , , , , , ,#,#,#,#,#,#, , , , ,#,#,#,#, , , ,#,#,#,#,#,
#,#,#, , ,#,#,#,#,#,#,#, , , ,#,#,#, , , , , ,#,#,#, , , , , , , , , , , ,#,#,#,#,#,#, , ,#,#,#,#,#,
#,#,#, , ,#,#,#,#,#,#,#, , , , , , , , , ,#,#,#,#,#,#, , , , , , , , , , ,#,#,#,#,#,#, , ,#,#,#,#,#,
#,#,#, , ,#,#,#,#,#,#, , , , , , , , , ,#,#,#,#,#,#,#, , , , , , , , , , , ,#,#,#,#,#, , , ,#,#,#,#,
#,#,#,#, , ,#,#,#,#, , , , , , , , , ,#,#,#,#,#,#,#,#, , , , , , , , , , , , ,#,#,#,#, , , , ,#,#,#,
#,#,#,#, , , , , , , , , , , , , , , ,#,#,#,#,#,#,#, , , , , , , , , , , , , , ,#,#, , , , , ,#,#,#,
#,#,#,#, , , , , , , , , , , , , , , , ,#,#,#,#,#, , , , ,#,#,#,#,#,#,#,#, , , ,#,#, , , , , ,#,#,#,
#,#,#,#, , , , , , , ,#,#, , , , , , , , ,#,#,#,#, , , ,#,#,#,#,#,#,#,#,#,#, , ,#,#,#, , , ,#,#,#,#,
#,#,#,#,#, , , , , ,#,#,#,#, , , , , , , , ,#,#, , , ,#,#,#,#,#,#,#,#,#,#,#, , ,#,#,#, , ,#,#,#,#,#,
#,#,#,#,#, , , , , ,#,#,#,#,#,#,#, , , , , , , , , , ,#,#,#,#,#,#,#,#,#,#,#, , ,#,#,#, , ,#,#,#,#,#,
#,#,#,#,#, , , , , ,#,#,#,#,#,#,#,#,#,#, , , , , , , ,#,#,#,#,#,#,#,#,#,#, , ,#,#,#,#, , ,#,#,#,#,#,
#,#,#,#,#, , , , , ,#,#,#,#,#,#,#,#,#,#,#, , , , , ,#,#,#,#,#,#,#,#,#,#, , , ,#,#,#,#, , ,#,#,#,#,#,
#,#,#,#,#, , , , , ,#,#,#,#,#,#,#,#,#,#,#, , , , , ,#,#,#,#,#,#,#,#,#, , , ,#,#,#,#,#, , ,#,#,#,#,#,
#,#,#,#, , , , , , ,#,#,#,#,#,#,#,#,#,#, , , , , , ,#,#,#,#,#,#,#,#,#, , ,#,#,#,#,#,#, , ,#,#,#,#,#,
#,#, , , , , , , , ,#,#,#,#,#,#,#,#,#, , , , , , , ,#,#,#,#,#,#,#,#,#, , ,#,#,#,#,#,#, , ,#,#,#,#,#,
#, , , , ,#,#,#, , ,#,#,#,#,#,#,#, , , , , , , , , , ,#,#,#,#,#,#,#,#, , , ,#,#,#,#, , , ,#,#,#,#,#,
#, , , ,#,#,#,#,#, , ,#,#,#,#,#, , , , , ,#,#, , , , ,#,#,#,#,#,#,#,#, , , , ,#,#,#, , ,#,#,#,#,#,#,
#, , , ,#,#,#,#,#, , ,#,#,#,#,#, , , , ,#,#,#,#, , , ,#,#,#,#,#,#,#,#,#, , , ,#,#, , , ,#,#,#,#,#,#,
#, , , ,#,#,#,#,#, , ,#,#,#,#,#,#, , , ,#,#,#,#, , , ,#,#,#,#,#,#,#,#,#,#, , ,#,#, , , ,#,#,#,#,#,#,
#,#, , , ,#,#,#, , , , ,#,#,#,#,#, , , ,#,#,#,#,#, , ,#,#,#,#,#,#,#,#,#,#, , ,#,#,#, , , ,#,#,#,#,#,
#,#,#, , , , , , , , ,#,#,#,#,#,#, , , ,#,#,#,#,#, , ,#,#,#,#,#,#,#,#,#,#, , , ,#,#, , , ,#,#,#,#,#,
#,#,#,#,#, , , , ,#,#,#,#,#,#,#,#, , , ,#,#,#,#,#, , ,#,#,#,#,#,#,#,#,#,#, , , ,#,#, , , ,#,#,#,#,#,
#,#,#,#,#,#,#,#,#,#,#,#,#,#,#,#,#,#, , , ,#,#,#, , , ,#,#,#,#,#,#,#,#,#, , , , ,#,#,#, , ,#,#,#,#,#,
#,#,#,#,#,#,#,#,#,#,#,#,#,#,#,#,#,#,#, , , , , , , , ,#,#,#,#,#,#,#,#,#, , , , ,#,#,#, , ,#,#,#,#,#,
#,#,#,#,#,#,#,#,#,#,#,#,#,#,#,#,#,#,#,#,#, , , , , , ,#,#,#,#,#,#,#,#,#, , , ,#,#,#,#, , ,#,#,#,#,#,
#,#,#,#,#,#,#,#,#,#,#,#,#,#,#,#,#,#,#,#,#,#,#, , , , ,#,#,#,#,#,#,#,#,#, , ,#,#,#,#,#, , ,#,#,#,#,#,
#,#,#,#,#,#,#,#,#,#,#,#,#,#,#,#,#,#,#,#,#,#,#,#, , , ,#,#,#,#,#,#,#,#,#, , ,#,#,#,#,#, , ,#,#,#,#,#,
#,#,#,#,#,#,#,#,#,#,#,#,#,#,#,#,#,#,#,#,#,#,#,#,#,#,#,#,#,#,#,#,#,#,#, , , ,#,#,#,#,#, , , ,#,#,#,#,
#,#,#,#,#,#,#,#,#,#,#,#,#,#,#,#,#,#,#,#,#,#,#,#,#,#,#,#,#,#,#,#,#,#,#, , , ,#,#,#,#,#, , , ,#,#,#,#,
#,#,#,#,#,#,#,#,#,#,#,#,#,#,#,#,#,#,#,#,#,#,#,#,#,#,#,#,#,#,#,#,#,#,#, , , , ,#,#,#,#, , , ,#,#,#,#,
#,#,#,#,#,#,#,#, , , ,#,#,#,#,#,#,#,#,#,#,#,#,#,#,#,#,#,#,#,#,#,#,#, , , , , , ,#,#, , , , ,#,#,#,#,
#,#,#,#,#, , , , , , , ,#,#,#, , ,#,#,#,#,#,#,#,#,#,#,#,#,#,#,#,#,#,#, ,#,#, , , , , , , , ,#,#,#,#,
#,#,#,#, , , , ,#,#, , , , , , , ,#,#,#,#,#,#,#,#,#,#,#,#,#,#,#,#,#,#,#,#,#,#, , , , , , , ,#,#,#,#,
#,#,#,#, , , ,#,#,#,#, , , , , , ,#,#,#,#,#,#,#,#,#,#,#,#,#,#,#,#,#,#,#,#,#,#, , , , , , , ,#,#,#,#,
#,#,#,#, , ,#,#,#,#,#,#, , , , , ,#,#,#,#,#, , , , , , ,#,#,#,#,#,#,#,#,#,#,#, , , , , , ,#,#,#,#,#,
#,#,#, , , ,#,#,#,#,#,#,#, , , , , ,#,#, , , , , , , , , , ,#,#,#,#,#,#,#,#,#, , , , , ,#,#,#,#,#,#,
#,#,#, , , ,#,#,#,#,#,#,#, , , , , , , , , , ,#,#,#,#, , , , ,#,#,#,#,#,#,#, , , , , , ,#,#,#,#,#,#,
#,#,#, , , , ,#,#,#,#,#,#, , , , , , , , , ,#,#,#,#,#,#, , , , , , ,#,#, , , , ,#,#, , , ,#,#,#,#,#,
#,#, , , , , , , , ,#,#, , , , , , , , , , ,#,#,#,#,#,#,#, , , , , , , , , ,#,#,#,#,#, , ,#,#,#,#,#,
#,#, , , , , , , , , , , , ,#,#, , , , , , , ,#,#,#,#,#,#,#, , , , , , , ,#,#,#,#,#,#, , ,#,#,#,#,#,
#,#, , , , , ,#,#,#,#, , ,#,#,#,#, , , , , , , ,#,#,#,#,#,#, , , , , , , ,#,#,#,#,#,#,#, , ,#,#,#,#,
#,#, , , , ,#,#,#,#,#,#,#,#,#,#,#,#, , , , , , , ,#,#,#,#,#,#, , , , , , , ,#,#,#,#,#,#, , ,#,#,#,#,
#,#, , , , ,#,#,#,#,#,#,#,#,#,#,#,#,#,#,#,#,#, , ,#,#,#,#,#,#,#, , , , , , , ,#,#,#,#, , , ,#,#,#,#,
#,#,#, , ,#,#,#,#,#,#,#,#,#,#,#,#,#,#,#,#,#,#,#,#,#,#,#,#,#,#,#,#,#,#,#, , , , , , , , , ,#,#,#,#,#,
#,#,#,#,#,#,#,#,#,#,#,#,#,#,#,#,#,#,#,#,#,#,#,#,#,#,#,#,#,#,#,#,#,#,#,#,#, , , , , , , ,#,#,#,#,#,#,
#,#,#,#,#,#,#,#,#,#,#,#,#,#,#,#,#,#,#,#,#,#,#,#,#,#,#,#,#,#,#,#,#,#,#,#,#,#,#,#,#,#,#,#,#,#,#,#,#,#,
#,#,#,#,#,#,#,#,#,#,#,#,#,#,#,#,#,#,#,#,#,#,#,#,#,#,#,#,#,#,#,#,#,#,#,#,#,#,#,#,#,#,#,#,#,#,#,#,#,#,
