#,#,#,#,#,#,#,#,#,#,#,#,#,#,#,#,#,#,#,#,#,#,#,#,#,#,#,#,#,#,#,#,#,#,#,#,#,#,#,#,#,#,#,#,#,#,#,#,#,#,
#,#, , , , , ,#,#,#,#, , , , , , , , , ,#,#,#,#,#,#,#,#,#,#,#,#,#,#,#,#,#, , ,#,#,#,#,#,#,#,#,#,#,#,
#, , , , , , , , , , , , , , , , , , , , ,#,#,#,#,#,#,#,#,#,#,#,#,#,#,#, , , , , ,#,#,#,#,#,#,#,#,#,
#, , , ,#,#,#,#, , , , , , , , ,#,#, , , ,#,#,#,#,#,#,#,#,#,#,#,#,#,#, , , , , , , ,#,#,#,#,#,#,#,#,
#, , ,#,#,#,#,#,#, , , , , , ,#,#,#,#, , ,#,#,#,#,#,#,#,#,#,#,#,#,#, , , , , , , , ,#,#,#,#,#,#,#,#,
#, , ,#,#,#,#,#,#, , , , , , ,#,#,#,#,#, , ,#,#,#,#,#,#,#,#,#,#,#, , , , ,#,#, , , ,#,#,#,#,#,#,#,#,
#, , ,#,#,#,#,#, , , ,#,#, , , ,#,#,#,#, , ,#,#,#,#,#,#,#,#,#,#, , , , ,#,#,#,#, , , ,#,#,#,#,#,#,#,
#, , , ,#,#,#, , , ,#,#,#,#, , ,#,#,#,#, , , ,#,#,#,#,#, , , , , , , , ,#,#,#,#,#, , , ,#,#,#,#,#,#,
#,#, , , , , , , ,#,#,#,#,#,#, , ,#,#,#,#, , , ,#,#, , , , , , , , , , ,#,#,#,#,#, , , , ,#,#,#,#,#,
#,#,#, , , , , , ,#,#,#,#,#,#, , ,#,#,#,#,#, , , , , , , ,#,#,#,#, , , , ,#,#,#, , , , , ,#,#,#,#,#,
#,#,#, , , , , , ,#,#,#,#,#,#,#, , ,#,#,#,#,#, , , , , ,#,#,#,#,#, , , , , , , , , , , , ,#,#,#,#,#,
#,#, , , , , , , , ,#,#,#,#,#,#, , ,#,#,#,#,#,#, , , , , ,#,#,#,#, , , , , , , , , , , , ,#,#,#,#,#,
#, , , ,#,#,#,#, , , ,#,#,#,#,#, , ,#,#,#,#,#,#, , , , , , , , , , ,#,#,#, , ,#,#, , , ,#,#,#,#,#,#,
#, , ,#,#,#,#,#,#, , ,#,#,#,#,#, , ,#,#,#,#,#,#, , , , , , , , , ,#,#,#,#,#,#,#,#,#,#,#,#,#,#,#,#,#,
#, , ,#,#,#,#,#,#, , ,#,#,#,#,#,#, , ,#,#,#,#,#, , , , , , , , , ,#,#,#,#,#,#,#,#,#,#,#,#,#,#,#,#,#,
#, , ,#,#,#,#,#, , , ,#,#,#,#,#,#, , , ,#,#,#,#, , , , , , , , , ,#,#,#,#,#,#,#,#,#,#,#,#,#,#,#,#,#,
#, , ,#,#,#,#, , , ,#,#,#,#,#,#,#, , , , ,#,#,#,#, , , , , , , , ,#,#,#,#,#,#,#,#,#,#,#,#,#,#,#,#,#,
#, , , ,#,#, , , , ,#,#,#,#,#,#,#,#, , , ,#,#,#,#,#, , , , , , ,#,#,#,#,#,#,#,#,#,#,#,#,#,#,#,#,#,#,
#,#, , , , , , , ,#,#,#,#,#,#,#,#,#,#,#,#,#,#,#,#,#, , , , , , ,#,#,#,#,#,#,#,#,#,#,#,#,#,#,#,#,#,#,
#,#,#, , , , , , ,#,#,#,#,#,#,#,#,#,#,#,#,#,#,#,#,#,#, , , , ,#,#,#,#,#,#,#,#,#,#,#,#,#,#,#,#,#,#,#,
#,#,#, , , , , , , ,#,#,#,#,#,#,#,#,#,#,#,#,#,#,#,#,#,#, , , ,#,#,#,#,#,#,#,#,#,#,#,#,#,#,#,#,#,#,#,
#,#,#, , , , , , , , ,#,#,#,#,#,#,#,#,#,#,#,#,#,#,#,#,#,#, , ,#,#,#,#,#,#,#,#,#, , , ,#,#,#,#,#,#,#,
#,#,#, , , ,#,#, , , , ,#,#,#,#,#,#,#,#,#,#,#,#,#,#,#,#,#, , ,#,#,#,#,#,#, , , , , , , ,#,#,#,#,#,#,
#,#, , , ,#,#,#,#, , , , ,#,#,#,#,#,#,#,#,#,#,#,#,#,#,#,#, , , ,#,#,#, , , , , , , , , , , ,#,#,#,#,
#,#, , ,#,#,#,#,#,#, , , , ,#,#,#,#,#,#,#,#,#,#,#,#,#,#,#, , , , , , , , , , ,#,#, , , , , , ,#,#,#,
#,#, , ,#,#,#,#,#,#, , , , , ,#,#,#,#,#,#,#,#,#,#,#,#,#,#, , , , , , , , , ,#,#,#,#,#,#, , , ,#,#,#,
#,#, , , ,#,#,#,#,#,#, , , , ,#,#,#,#,#,#,#, , ,#,#,#,#,#, , , , , , , , , ,#,#,#,#,#,#,#, , ,#,#,#,
#,#,#, , , ,#,#,#,#,#, , , ,#,#,#,#,#,#,#, , , , ,#,#,#, , , , , , , , , , ,#,#,#,#,#,#,#, , ,#,#,#,
#,#,#, , , , ,#,#,#, , , ,#,#,#,#,#,#,#,#, , , , , , , , , , , , , , , , , , ,#,#,#,#,#,#,#, ,#,#,#,
#,#,#,#, , , , ,#, , , ,#,#,#,#,#,#,#,#,#, , , , , , , , ,#,#,#, , , , , , , , ,#,#,#,#,#,#, , ,#,#,
#,#,#,#, , , , , , , ,#,#,#,#,#,#,#,#,#,#, , , , , ,#,#,#,#,#,#,#,#, , , , , , , ,#,#,#,#, , , ,#,#,
#,#,#,#, , , , , , , ,#,#,#,#,#,#,#,#,#,#, , , , ,#,#,#,#,#,#,#,#,#,#,#, , , , , , ,#,#, , , , ,#,#,
#,#,#,#, , , , , , , ,#,#,#,#,#,#,#,#,#,#, , , ,#,#,#,#,#,#,#,#,#,#,#,#,#, , , , , , , , , , ,#,#,#,
#,#,#,#,#, , , , , , ,#,#,#,#,#,#,#,#,#,#, , , ,#,#,#,#,#,#,#,#,#,#,#,#, , , , , , , , , , , ,#,#,#,
#,#,#,#,#, , , , , , ,#,#,#,#,#,#,#,#,#,#, , , ,#,#,#,#,#,#,#,#, ,#,#, , , , , , , , , , , ,#,#,#,#,
#,#,#,#,#,#, , , , , , ,#,#,#,#,#,#,#,#,#, , , ,#,#,#,#,#,#,#, , , , , , , , , , , ,#,#,#,#,#,#,#,#,
#,#,#,#,#,#, , , , , , , ,#,#,#,#,#,#,#,#,#, ,#,#,#,#,#,#,#,#, , , , , , , , , , ,#,#,#,#,#,#,#,#,#,
#,#,#,#,#, , , , ,#,#, , , ,#,#,#,#,#,#,#,#,#,#,#,#,#,#,#,#,#, , , , , , , , , ,#,#,#,#,#,#,#,#,#,#,
#,#,#,#, , , , ,#,#,#,#, , ,#,#,#,#,#,#,#,#,#,#,#,#,#,#,#,#, , , ,#,#,#, , , ,#,#,#,#,#,#,#,#,#,#,#,
#,#,#,#, , , ,#,#,#,#,#, , ,#,#,#,#,#,#,#,#,#,#,#,#,#, , , , , ,#,#,#,#,#,#,#,#,#,#,#,#,#,#,#,#,#,#,
#,#,#,#, , , ,#,#,#,#,#, , , ,#,#,#,#,#,#,#,#,#,#,#, , , , , ,#,#,#,#,#,#,#,#,#,#,#,#,#,#,#,#,#,#,#,
#,#,#,#,#, , ,#,#,#,#,#, , , , ,#,#,#,#,#,#,#,#,#,#, , , , , ,#,#,#,#,#,#,#,#,#,#,#,#,#,#,#,#,#,#,#,
#,#,#,#,#,#, , ,#,#,#, , , , , ,#,#,#,#,#,#,#,#,#,#, , , , , ,#,#,#,#,#,#,#,#,#,#,#,#,#,#,#,#,#,#,#,
#,#,#,#,#,#,#, , , , , , , , , ,#,#,#,#,#,#,#,#,#,#,#, , , , ,#,#,#,#,#,#,#,#,#,#,#,#,#,#,#,#,#,#,#,
#,#,#,#,#,#,#,#, , , , , , , ,#,#,#,#,#,#,#,#,#,#,#,#,#, , , , ,#,#,#,#,#,#,#,#,#,#,#,#,#,#,#,#,#,#,
#,#,#,#,#,#,#,#,#,#,#,#,#,#,#,#,#,#,#,#,#,#,#,#,#,#,#,#,#, , , , , , , ,#,#,#,#,#,#,#,#,#,#,#,#,#,#,
#,#,#,#,#,#,#,#,#,#,#,#,#,#,#,#,#,#,#,#,#,#,#,#,#,#,#,#,#, , , , , , , ,#,#,#,#,#,#,#,#,#,#,#,#,#,#,
#,#,#,#,#,#,#,#,#,#,#,#,#,#,#,#,#,#,#,#,#,#,#,#,#,#,#,#,#,#, , , , ,#,#,#,#,#,#,#,#,#,#,#,#,#,#,#,#,
#,#,#,#,#,#,#,#,#,#,#,#,#,#,#,#,#,#,#,#,#,#,#,#,#,#,#,#,#,#,#,#,#,#,#,#,#,#,#,#,#,#,#,#,#,#,#,#,#,#,
#,#,#,#,#,#,#,#,#,#,#,#,#,#,#,#,#,#,#,#,#,#,#,#,#,#,#,#,#,#,#,#,#,#,#,#,#,#,#,#,#,#,#,#,#,#,#,#,#,#,
