#,#,#,#,#,#,#,#,#,#,#,#,#,#,#,#,#,#,#,#,#,#,#,#,#,#,#,#,#,#,#,#,#,#,#,#,#,#,#,#,#,#,#,#,#,#,#,#,#,#,
#,#,#,#,#,#,#,#,#,#,#,#,#,#,#,#,#,#,#,#,#,#,#,#,#,#,#,#,#,#, , , , , , , , ,#,#,#,#,#,#,#,#,#,#,#,#,
#,#,#,#,#,#,#,#,#,#,#,#,#,#,#,#,#,#,#,#,#,#,#,#,#,#,#,#, , , , , , , , , , , ,#,#,#,#,#,#,#,#,#,#,#,
#,#,#,#,#,#,#, , , , , ,#,#,#,#,#,#,#,#,#,#,#,#,#,#,#, , , , , ,#,#,#,#,#, , , ,#,#,#,#,#,#,#,#,#,#,
#,#,#,#,#, , , , , , , , ,#,#,#,#,#,#,#,#,#,#,#,#,#,#, , , , ,#,#,#,#,#,#,#, , , ,#,#,#,#,#,#,#,#,#,
#,#,#,#, , , , , , , , , , ,#,#,#,#,#,#,#,#,#,#,#,#,#,#, , , ,#,#,#,#,#,#,#,#, , ,#,#,#,#,#,#,#,#,#,
#,#,#, , , ,#,#,#,#,#, , , , ,#,#,#,#,#,#,#,#,#,#,#,#,#, , , ,#,#,#,#,#,#,#,#, , , ,#,#,#,#,#,#,#,#,
#,#,#, , ,#,#,#,#,#,#,#, , , , ,#,#,#,#,#,#,#,#,#,#,#,#, , , , ,#,#,#,#,#,#,#, , , ,#,#,#,#,#,#,#,#,
#,#,#, , ,#,#,#,#,#,#,#, , , , ,#,#,#,#,#,#,#,#,#,#,#,#, , , , , , ,#,#,#,#, , , , ,#,#,#,#,#,#,#,#,
#,#,#, , , ,#,#,#,#,#,#, , , , ,#,#,#,#,#,#,#,#,#,#,#,#,#, , , , , , , , , , , , , ,#,#,#,#,#,#,#,#,
#,#,#,#, , , ,#,#,#,#,#, , , , , ,#,#, , ,#,#,#,#,#,#,#,#,#,#,#,#, , , , , , , , , , ,#,#,#, ,#,#,#,
#,#,#,#,#, , , ,#,#,#, , , , , , , , , , , ,#,#,#,#,#,#,#,#,#,#,#,#, , , , , , , , , , , , , , ,#,#,
#,#,#,#,#,#, , , , , , , , , , , , , , , , ,#,#,#,#,#,#,#,#,#,#,#,#,#, , , , , ,#,#, , , , , , ,#,#,
#,#,#,#,#,#,#,#,#, , , , , ,#,#,#,#, , , , ,#,#,#,#,#,#,#,#,#,#,#,#,#, , , , ,#,#,#,#, , , , , ,#,#,
#,#,#,#,#,#,#,#,#,#,#, , ,#,#,#,#,#,#,#, , , ,#,#,#,#,#,#,#,#,#,#,#,#,#, , , ,#,#,#,#,#, , , , ,#,#,
#,#,#,#,#,#,#,#,#,#,#,#, ,#,#,#,#,#,#,#,#, , ,#,#,#,#,#,#,#,#,#,#,#,#,#, , , ,#,#,#,#,#,#, , , ,#,#,
#,#,#,#,#,#,#,#,#,#,#,#, , ,#,#,#,#,#,#,#, , ,#,#,#,#,#,#,#,#,#,#,#,#,#,#, , , ,#,#,#,#,#,#, , ,#,#,
#,#,#,#,#,#,#,#,#,#,#,#, , , ,#,#,#,#,#,#,#, , ,#,#,#,#,#,#,#,#,#,#,#,#,#,#, , ,#,#,#,#,#,#, , ,#,#,
#,#,#,#,#,#,#,#,#,#,#,#,#, , , ,#,#,#,#,#,#, , , , , , ,#,#,#,#,#,#,#,#,#,#,#, , ,#,#,#,#, , , ,#,#,
#,#,#,#,#,#,#,#,#,#,#,#,#,#, , , , , , ,#,#,#, , , , , , ,#,#,#,#,#,#,#,#,#,#, , , ,#,#, , , , , ,#,
#,#,#,#,#,#,#,#,#,#,#,#,#,#,#, , , , , , ,#,#,#,#, , , , , ,#,#,#,#,#,#,#,#,#,#, , , , , , , , , ,#,
#,#,#,#,#,#,#,#,#,#,#,#,#,#,#,#, , , , , , ,#,#,#,#,#,#, , , ,#,#,#,#,#,#,#,#,#, , , , , , , , ,#,#,
#,#,#,#,#,#,#,#,#,#,#,#,#,#,#,#,#, , , , , , ,#,#,#,#,#,#, , , ,#,#,#,#,#,#,#,#, , , , , ,#,#,#,#,#,
#,#,#,#,#,#,#,#,#,#,#,#,#,#,#,#,#,#,#,#, , , ,#,#,#,#,#,#,#, , , ,#,#,#,#,#,#, , , , , ,#,#,#,#,#,#,
#,#,#,#,#,#,#,#,#,#,#,#,#,#,#,#,#,#,#,#,#, , ,#,#,#,#,#,#,#,#, , , ,#,#, , , , , , , , ,#,#,#,#,#,#,
#,#, , , ,#,#,#,#,#,#,#,#,#,#,#,#,#,#,#,#, , , ,#,#,#,#,#,#,#,#, , , , , , , , , , , , ,#,#,#,#,#,#,
#,#, , , ,#,#,#,#,#,#,#,#,#,#,#,#,#,#,#,#,#, , , ,#,#,#,#,#,#,#,#,#,#, , , , ,#,#, , , ,#,#,#,#,#,#,
#,#,#, , , ,#,#,#,#,#,#,#,#,#,#,#,#,#,#,#,#,#,#, , ,#,#,#, , , ,#,#,#,#,#,#,#,#,#,#, , ,#,#,#,#,#,#,
#,#,#, , , , , , ,#,#,#,#,#,#,#,#,#,#,#,#,#,#,#,#, , , , , , , , , ,#,#,#,#,#,#,#,#,#, , ,#,#,#,#,#,
#,#,#, , , , , , , ,#,#,#,#,#,#,#,#,#,#,#,#,#,#,#, , , , , ,#,#, , , , ,#,#,#,#,#,#,#, , , ,#,#,#,#,
#,#, , , , , , , , , ,#,#,#,#,#,#,#,#,#,#,#,#,#, , , , , ,#,#,#,#, , , , ,#,#,#,#,#,#, , , ,#,#,#,#,
#,#, , , , ,#,#,#, , , ,#,#,#,#,#,#,#,#,#,#, , , , , , , ,#,#,#,#,#, , , , ,#,#,#,#, , , ,#,#,#,#,#,
#,#, , , ,#,#,#,#,#, , ,#,#,#,#,#,#,#,#,#, , , , , , , , ,#,#,#,#,#,#,#, , , ,#,#, , , ,#,#,#,#,#,#,
#,#, , ,#,#,#,#,#,#, , ,#,#,#,#,#,#,#,#,#, , , ,#,#,#, , , ,#,#,#,#,#,#,#, , , , , , , ,#,#,#,#,#,#,
#,#, , ,#,#,#,#,#,#,#, , ,#,#,#,#,#,#,#, , , ,#,#,#,#,#, , ,#,#,#,#,#,#,#,#, , , , , ,#,#,#,#,#,#,#,
#,#,#, , ,#,#,#,#,#,#, , , ,#,#,#,#,#, , , , ,#,#,#,#,#, , ,#,#,#,#,#,#,#,#, , , , , ,#,#,#,#,#,#,#,
#,#,#, , , ,#,#,#,#,#, , , ,#,#,#,#,#, , , ,#,#,#,#,#,#, , ,#,#,#,#,#,#,#,#, , , , , ,#,#,#,#,#,#,#,
#,#,#, , , , , , , ,#,#, , , ,#,#,#,#,#, ,#,#,#,#,#,#,#, , ,#,#,#,#,#,#,#,#, , , , , , ,#,#,#,#,#,#,
#,#,#, , , , , , , , ,#,#, ,#,#,#,#,#,#,#,#,#,#,#,#,#, , , ,#,#,#,#,#,#,#,#, , , , , , ,#,#,#,#,#,#,
#,#,#,#,#,#,#,#,#, , ,#,#,#,#,#,#,#,#,#,#,#,#,#,#, , , , , ,#,#,#,#,#,#,#, , , ,#,#, , , ,#,#,#,#,#,
#,#,#,#,#,#,#,#,#,#, , ,#,#,#,#,#,#,#,#,#,#,#,#, , , , , ,#,#,#,#,#,#,#, , , ,#,#,#,#, , ,#,#,#,#,#,
#,#,#,#,#,#,#,#,#,#, , ,#,#,#,#,#,#,#,#,#,#,#, , ,#,#,#,#,#,#,#,#,#,#, , , ,#,#,#,#,#, , ,#,#,#,#,#,
#,#,#,#,#,#,#,#,#,#, , ,#,#,#,#,#,#,#,#,#,#, , ,#,#,#,#,#,#,#,#,#,#,#, , , ,#,#,#,#,#, , ,#,#,#,#,#,
#,#,#,#,#,#,#,#,#, , , ,#,#,#,#,#,#,#,#,#, , ,#,#,#,#,#,#,#,#,#,#,#,#, , , ,#,#,#,#,#, , ,#,#,#,#,#,
#,#,#,#,#,#,#,#,#, , , ,#,#,#,#,#,#,#,#, , ,#,#,#,#,#,#,#,#,#,#,#,#,#, , , , ,#,#,#, , ,#,#,#,#,#,#,
#,#,#,#,#,#,#,#,#,#, , , ,#,#,#,#,#,#, , ,#,#,#,#,#,#,#,#,#,#,#,#,#,#,#, , , , , , , , ,#,#,#,#,#,#,
#,#,#,#,#,#,#,#,#,#, , , , ,#,#,#,#, , ,#,#,#,#,#,#,#,#,#,#,#,#,#,#,#,#,#, , , , , , ,#,#,#,#,#,#,#,
#,#,#,#,#,#,#,#,#,#,#, , , , , , , , ,#,#,#,#,#,#,#,#,#,#,#,#,#,#,#,#,#,#,#,#,#,#,#,#,#,#,#,#,#,#,#,
#,#,#,#,#,#,#,#,#,#,#,#,#,#, , , , ,#,#,#,#,#,#,#,#,#,#,#,#,#,#,#,#,#,#,#,#,#,#,#,#,#,#,#,#,#,#,#,#,
#,#,#,#,#,#,#,#,#,#,#,#,#,#,#,#,#,#,#,#,#,#,#,#,#,#,#,#,#,#,#,#,#,#,#,#,#,#,#,#,#,#,#,#,#,#,#,#,#,#,
