#,#,#,#,#,#,#,#,#,#,#,#,#,#,#,#,#,#,#,#,#,#,#,#,#,#,#,#,#,#,#,#,#,#,#,#,#,#,#,#,#,#,#,#,#,#,#,#,#,#,
#,#,#,#,#,#,#,#,#,#,#,#,#,#,#,#,#,#,#,#,#, , ,#,#,#,#,#,#,#,#,#,#,#,#,#,#,#, , , ,#,#,#,#,#,#,#,#,#,
#,#,#,#,#,#,#,#,#,#,#,#,#,#, , ,#,#,#, , , , , ,#,#,#,#,#,#,#,#,#,#,#,#,#, , , , , ,#,#,#,#,#,#,#,#,
#,#,#, , , , ,#,#,#,#,#,#, , , , , , , , , , , , ,#,#,#,#,#,#,#,#,#,#,#, , , , , , , ,#,#,#,#,#,#,#,
#,#, , , , , , ,#,#,#,#,#, , , , , , , ,#,#, , , , ,#,#,#,#,#,#,#,#,#,#, , , ,#,#, , , ,#,#,#,#,#,#,
#, , , ,#,#,#, , , ,#,#, , , , , , , ,#,#,#,#, , , , ,#,#,#,#,#,#,#,#,#, , ,#,#,#,#, , ,#,#,#,#,#,#,
#, , ,#,#,#,#,#, , , , , , , , , , ,#,#,#,#,#,#, , , ,#,#,#,#,#,#,#,#, , ,#,#,#,#,#, , ,#,#,#,#,#,#,
#, , ,#,#,#,#,#,#, , , , , , , , , ,#,#,#,#,#,#, , , ,#,#,#,#,#,#,#,#, , ,#,#,#,#,#, , ,#,#,#,#,#,#,
#, , ,#,#,#,#,#,#, , , , , , , , , ,#,#,#,#,#,#, , , ,#,#,#,#,#,#,#,#, , , ,#,#,#,#, , , ,#,#,#,#,#,
#, , ,#,#,#,#,#,#, , , , , , , , , ,#,#,#,#,#,#, , , ,#,#,#,#,#,#,#, , , , , ,#,#, , , , ,#,#,#,#,#,
#, , , ,#,#,#,#,#, , , , , , , , , , ,#,#,#,#,#, , , ,#,#,#,#,#, , , , , , , , , , , , , ,#,#,#,#,#,
#,#, , , , ,#,#, , , , , , , , , , , , ,#,#,#, , , , ,#,#,#,#, , , , , , , , , , , , , , ,#,#,#,#,#,
#,#,#,#, , , , , ,#,#, , , , ,#,#,#, , , , , , , , , ,#,#,#,#, , , , , , , , , , , , , ,#,#,#,#,#,#,
#,#,#,#,#, , , ,#,#,#,#, , ,#,#,#,#,#, , , , , , , , , ,#,#,#,#, , ,#,#, , , , , , , ,#,#,#,#,#,#,#,
#,#,#,#,#,#, , ,#,#,#,#,#,#,#,#,#,#,#, , , , , , , , , ,#,#,#,#,#,#,#,#,#, , , , , , ,#,#,#,#,#,#,#,
#,#,#,#,#,#, , ,#,#,#,#,#,#,#,#,#,#, , , , , , , , , , ,#,#,#,#,#,#,#,#,#,#, , , , , ,#,#,#,#,#,#,#,
#,#,#,#,#,#, , , ,#,#,#,#,#,#,#,#,#, , , , , , , , , , , ,#,#,#,#,#,#,#,#,#,#, , , , , ,#,#,#,#,#,#,
#,#,#,#,#,#, , , , ,#,#,#,#,#,#,#,#, , , , , , , , , , , , ,#,#,#,#,#,#,#,#,#, , , , , , ,#,#,#,#,#,
#,#,#,#,#, , , , , , ,#,#,#,#,#,#,#,#, ,#,#, , , , , , , , , ,#,#,#,#,#,#,#,#, , , , , , , ,#,#,#,#,
#,#,#,#,#, , , , , , , ,#,#,#,#,#,#,#,#,#,#,#, , , ,#,#,#, , , ,#,#,#,#,#,#, , , , , , , , ,#,#,#,#,
#,#,#,#,#,#, , , , , , , ,#,#,#,#,#,#,#,#,#,#, , ,#,#,#,#,#, , , , ,#,#,#, , , , ,#,#,#, , ,#,#,#,#,
#,#,#,#,#,#, , , ,#,#, , , ,#,#,#,#,#,#,#,#,#, , ,#,#,#,#,#, , , , ,#,#,#, , , ,#,#,#,#,#, , ,#,#,#,
#,#,#,#,#,#, , ,#,#,#,#,#, , ,#,#,#,#,#,#,#,#, , ,#,#,#,#,#, , , , , ,#,#, , ,#,#,#,#,#,#,#, , ,#,#,
#,#,#,#,#,#, , ,#,#,#,#,#,#, , ,#,#,#,#,#,#, , , ,#,#,#,#, , , , , , , , , , ,#,#,#,#,#,#,#, , ,#,#,
#,#,#,#,#,#, , ,#,#,#,#,#,#,#, , ,#,#,#,#,#, , , , ,#,#, , , , , , , , , , , , ,#,#,#,#,#, , ,#,#,#,
#,#,#,#,#, , , ,#,#,#,#,#,#,#, , ,#,#,#,#,#, , , , , , , , , ,#,#,#,#, , , , , , , , , , , ,#,#,#,#,
#,#,#,#,#, , , , ,#,#,#,#,#, , ,#,#,#,#,#,#, , , , , , , , ,#,#,#,#,#,#,#,#,#, , , , , , ,#,#,#,#,#,
#,#,#,#,#, , , , , , , , , , ,#,#,#,#,#,#,#,#, , , , , , , ,#,#,#,#,#,#,#,#,#,#,#,#,#,#,#,#,#,#,#,#,
#,#,#,#,#,#, , , , , , , , ,#,#,#,#,#,#,#,#,#,#, , , , , , , ,#,#,#,#,#,#,#,#,#,#,#,#,#,#,#,#,#,#,#,
#,#,#,#,#,#,#, , , , , , ,#,#,#,#,#,#,#,#,#,#,#, , , , , , , , ,#,#,#,#,#,#,#,#,#,#,#,#,#,#,#,#,#,#,
#,#,#,#,#,#,#, , , , , , ,#,#,#,#,#,#,#,#,#,#, , , , , , , , , , ,#,#,#,#,#,#,#,#,#,#,#,#,#,#,#,#,#,
#,#,#,#,#,#,#, , , , , , ,#,#,#,#,#,#,#,#,#, , , , , , , , , , , , , , , , ,#,#,#,#,#,#,#,#,#,#,#,#,
#,#,#,#,#,#,#,#, , , , , , ,#,#,#,#,#,#,#, , , ,#,#,#, , , , , , , , , , , , ,#,#,#,#,#,#,#,#,#,#,#,
#,#,#,#,#,#,#,#, , , , , , ,#,#,#,#,#,#, , , ,#,#,#,#,#, , , , , , , , , , , , ,#,#,#,#,#,#,#,#,#,#,
#,#,#,#,#,#,#, , , , , , , ,#,#,#,#,#, , , ,#,#,#,#,#,#, , , ,#,#, , , , , , , , , , , ,#,#,#,#,#,#,
#,#,#,#,#, , , , ,#,#, , , ,#,#,#,#,#, , , ,#,#,#,#,#,#, , ,#,#,#,#, , , , , , , , , , , ,#,#,#,#,#,
#,#,#,#, , , , ,#,#,#,#, , ,#,#,#,#,#, , , ,#,#,#,#,#, , , ,#,#,#,#,#, , , , , , ,#,#, , , ,#,#,#,#,
#,#,#, , , , ,#,#,#,#,#, , ,#,#,#,#,#,#, , , ,#,#,#, , , , ,#,#,#,#,#,#, , , , ,#,#,#,#, , , ,#,#,#,
#,#, , , , ,#,#,#,#,#,#, , ,#,#,#,#,#,#, , , , , , , , , , ,#,#,#,#,#,#, , , , ,#,#,#,#,#, , , ,#,#,
#,#, , , ,#,#,#,#,#,#,#, , ,#,#,#,#,#,#,#, , , , , , , , , , ,#,#,#,#,#, , , ,#,#,#,#,#,#,#, , ,#,#,
#,#, , , ,#,#,#,#,#,#, , , ,#,#,#,#,#,#,#,#,#, , , , , , , , , , ,#,#, , , , ,#,#,#,#,#,#,#, , ,#,#,
#,#,#, , , ,#,#,#,#,#, , ,#,#,#,#,#,#,#,#,#,#,#, , , ,#,#, , , , , , , , , , ,#,#,#,#,#,#, , , ,#,#,
#,#,#,#, , , ,#,#,#, , ,#,#,#,#,#,#,#,#,#,#,#,#, , ,#,#,#,#,#, , , , , , , , ,#,#,#,#,#, , , , ,#,#,
#,#,#,#,#, , , , , , , ,#,#,#,#,#,#,#,#,#,#,#, , , ,#,#,#,#,#,#, , , , , , , , , , , , , , , , ,#,#,
#,#,#,#,#,#, , , , , ,#,#,#,#,#,#,#,#,#,#,#,#, , , ,#,#,#,#,#,#, , , , , , , , , , , , , , , ,#,#,#,
#,#,#,#,#,#,#,#,#,#,#,#,#,#,#,#,#,#,#,#,#,#,#, , , ,#,#,#,#,#, , , , ,#,#,#, , , ,#,#,#,#,#,#,#,#,#,
#,#,#,#,#,#,#,#,#,#,#,#,#,#,#,#,#,#,#,#,#,#,#,#, , , ,#,#, , , , , ,#,#,#,#,#,#,#,#,#,#,#,#,#,#,#,#,
#,#,#,#,#,#,#,#,#,#,#,#,#,#,#,#,#,#,#,#,#,#,#,#,#, , , , , , , ,#,#,#,#,#,#,#,#,#,#,#,#,#,#,#,#,#,#,
#,#,#,#,#,#,#,#,#,#,#,#,#,#,#,#,#,#,#,#,#,#,#,#,#,#,#, , ,#,#,#,#,#,#,#,#,#,#,#,#,#,#,#,#,#,#,#,#,#,
#,#,#,#,#,#,#,#,#,#,#,#,#,#,#,#,#,#,#,#,#,#,#,#,#,#,#,#,#,#,#,#,#,#,#,#,#,#,#,#,#,#,#,#,#,#,#,#,#,#,
