#,#,#,#,#,#,#,#,#,#,#,#,#,#,#,#,#,#,#,#,#,#,#,#,#,#,#,#,#,#,#,#,#,#,#,#,#,#,#,#,#,#,#,#,#,#,#,#,#,#,
#,#,#,#,#,#,#,#,#,#,#,#,#,#,#,#,#,#,#,#,#,#,#,#,#,#,#,#,#,#,#,#,#,#,#, , , , , , , , ,#,#,#,#,#,#,#,
#,#,#,#,#,#,#,#,#,#,#,#,#,#,#,#,#, , , , , ,#,#,#,#,#,#,#,#,#,#,#,#, , , , , , , , , , ,#,#,#,#,#,#,
#,#,#,#,#,#,#,#,#,#,#,#,#,#,#,#, , , , , , , ,#,#,#,#,#,#,#,#,#,#,#, , , , ,#,#,#,#, , , ,#,#,#,#,#,
#,#,#,#,#, , , ,#,#,#,#,#,#,#, , , ,#,#,#, , , ,#,#,#,#,#,#,#,#,#,#, , , ,#,#,#,#,#,#, , , ,#,#,#,#,
#,#,#,#, , , , , ,#,#,#,#, , , , ,#,#,#,#,#, , , ,#,#,#,#,#,#,#,#,#,#, , ,#,#,#,#,#,#, , , ,#,#,#,#,
#,#,#, , ,#,#,#, , , , , , , , ,#,#,#,#,#,#,#, , , ,#,#,#,#,#,#,#,#,#,#, , ,#,#,#,#, , , , ,#,#,#,#,
#,#, , ,#,#,#,#,#, , , , , , , ,#,#,#,#,#,#,#, , , ,#,#,#,#,#,#,#,#,#,#, , , , , , , , , ,#,#,#,#,#,
#, , ,#,#,#,#,#,#,#, , , , , , ,#,#,#,#,#,#, , , , ,#,#,#,#,#,#,#,#,#,#,#, , , , , , , , ,#,#,#,#,#,
#, , ,#,#,#,#,#,#,#,#, , ,#,#, , ,#,#,#, , , , , , , ,#,#,#,#,#,#,#,#,#,#,#, , , , , , , ,#,#,#,#,#,
#,#, , ,#,#,#,#,#,#,#,#,#,#,#,#, , , , , , , , , , , , ,#,#,#,#,#,#,#,#,#,#, , , , , , , , ,#,#,#,#,
#,#,#, , ,#,#,#,#,#,#,#,#,#,#,#,#, , , , , , , , , , , ,#,#,#,#,#,#,#,#,#,#,#, , , , , , , ,#,#,#,#,
#,#,#, , , ,#,#,#,#,#,#,#,#,#,#,#,#, , ,#,#, , , , ,#,#,#,#,#,#,#,#,#,#,#,#,#, , , , , , , ,#,#,#,#,
#,#,#, , , , ,#,#,#,#,#,#,#,#,#,#,#,#,#,#,#,#, , ,#,#,#,#,#,#,#,#,#,#,#,#,#, , , , , , , ,#,#,#,#,#,
#,#,#, , , , , ,#,#,#,#,#,#,#,#,#,#,#,#,#,#,#, , ,#,#,#,#,#,#,#,#, , , , , , ,#,#,#, , , ,#,#,#,#,#,
#,#,#, , , , , , ,#,#,#,#,#,#,#,#,#,#,#,#,#,#, , ,#,#,#,#,#,#,#, , , , , , ,#,#,#,#,#, , ,#,#,#,#,#,
#,#,#,#, , , , , ,#,#,#,#,#,#,#,#,#,#,#,#,#,#,#, , ,#,#,#,#,#, , , , , , , ,#,#,#,#,#,#, , ,#,#,#,#,
#,#,#,#, , , , , ,#,#,#,#,#,#,#,#,#,#,#,#,#,#,#, , , ,#,#, , , , , , , , , , ,#,#,#,#,#, , , ,#,#,#,
#,#,#, , , , , , ,#,#,#,#,#,#,#,#,#,#,#,#,#,#,#, , , , , , , ,#,#, , , , , , , ,#,#,#,#, , , ,#,#,#,
#,#,#, , , , , , , ,#,#,#,#,#,#,#,#,#,#,#,#,#,#, , , , , , ,#,#,#,#,#,#,#, , , , ,#,#, , , , ,#,#,#,
#,#,#, , , , , , , ,#,#,#,#,#,#,#,#,#,#,#,#,#, , , , , , ,#,#,#,#,#,#,#,#,#,#, , , , , , , ,#,#,#,#,
#,#,#, , ,#,#,#, , , ,#,#,#,#,#,#,#,#,#, , , , , , , , ,#,#,#,#,#,#,#,#,#,#,#,#, , , , ,#,#,#,#,#,#,
#,#, , ,#,#,#,#,#, , ,#,#,#,#,#,#,#,#, , , , ,#,#, , , ,#,#,#,#,#,#,#,#,#,#,#,#,#,#,#,#,#,#,#,#,#,#,
#, , , ,#,#,#,#,#,#,#,#,#,#,#,#,#,#, , , ,#,#,#,#,#, , , ,#,#,#,#,#,#,#,#,#,#,#,#,#,#,#,#,#,#,#,#,#,
#, , ,#,#,#,#,#,#,#,#,#,#,#,#,#,#, , , ,#,#,#,#,#,#, , , ,#,#,#,#,#,#,#,#,#,#,#,#,#,#,#,#,#,#,#,#,#,
#, , ,#,#,#,#,#,#,#,#,#,#,#,#,#,#, , , ,#,#,#,#,#,#, , , ,#,#,#,#,#,#,#,#,#,#,#,#,#,#,#,#,#,#,#,#,#,
#,#, , ,#,#,#,#,#,#,#,#,#,#,#,#,#, , , ,#,#,#,#,#,#, , ,#,#,#,#,#,#,#,#,#,#,#,#,#,#,#,#,#,#,#,#,#,#,
#,#,#, , ,#,#,#,#,#,#,#,#,#,#,#,#, , , ,#,#,#,#,#, , ,#,#,#,#,#,#,#,#,#,#,#,#,#,#,#,#,#,#,#,#,#,#,#,
#,#,#, , , ,#,#,#,#,#,#,#,#,#,#,#,#, , , ,#,#,#, , , ,#,#,#,#,#,#,#,#,#,#,#,#,#,#,#,#,#,#,#,#,#,#,#,
#,#,#, , , , , , , , ,#,#,#,#,#,#,#,#, , , , , , , , ,#,#,#,#,#,#,#,#,#,#,#,#,#,#,#,#,#,#,#,#,#,#,#,
#,#,#, , , , , , , , , , , , ,#,#,#,#,#, , , , , , , , ,#,#,#,#,#,#,#,#,#,#,#,#,#,#,#,#,#,#,#,#,#,#,
#,#,#,#, , , , , , , , , , , ,#,#,#,#,#, , , , , , , , , , ,#,#,#,#,#,#,#,#,#,#, , , , ,#,#,#,#,#,#,
#,#,#,#,#, , , , , , , , , ,#,#,#,#,#,#, , , , , , , , , , , ,#,#,#,#,#,#,#, , , , , , , , ,#,#,#,#,
#,#,#,#,#,#, , , , , , , ,#,#,#,#,#,#,#,#, , , , , , , , , , , ,#,#,#,#, , , , , , ,#,#, , , ,#,#,#,
#,#,#,#,#,#,#, , , , , , ,#,#,#,#,#,#,#,#,#,#, , , , , , , , , , ,#,#, , , , , , ,#,#,#,#, , ,#,#,#,
#,#,#,#,#,#,#, , , , , , ,#,#,#,#,#,#,#,#,#,#,#, , , , , , , , , , , , , , , , ,#,#,#,#,#, , ,#,#,#,
#,#,#,#,#,#,#, , , , , , ,#,#,#,#,#,#,#,#,#,#,#, , , , , , , , , , , , , ,#,#,#,#,#,#,#,#, , ,#,#,#,
#,#,#,#,#,#,#,#, , , , , ,#,#,#,#,#,#,#,#,#,#,#, , , , ,#, , , , , , , ,#,#,#,#,#,#,#,#,#, , ,#,#,#,
#,#,#,#,#,#,#,#,#,#,#, , , ,#,#,#,#,#,#,#,#,#,#, , , ,#,#,#, , , , , , , ,#, , ,#,#,#,#, , , ,#,#,#,
#,#,#,#,#,#,#,#,#,#,#,#, , , ,#,#,#,#,#,#,#,#, , , , ,#,#,#,#, , , , , , , , , , , , , , , ,#,#,#,#,
#,#,#,#,#,#,#,#,#,#,#,#, , , , , , ,#,#,#,#,#, , , ,#,#,#,#,#,#, , , , , , , , , , , , , , ,#,#,#,#,
#,#,#,#,#,#,#,#,#,#,#,#, , , , , , , ,#,#,#,#, , , ,#,#,#,#,#,#,#, , , , , , , , , , , , , ,#,#,#,#,
#,#,#,#, , ,#,#,#,#,#,#, , , , , , , ,#,#,#,#,#, , ,#,#,#,#,#,#,#, , , , , , , , , , , , , ,#,#,#,#,
#,#,#, , , , ,#,#,#,#, , , , , , , ,#,#,#,#,#,#, , ,#,#,#,#,#,#, , , , , , , , , , , , , , ,#,#,#,#,
#,#,#,#, , , , ,#,#, , , ,#,#,#,#,#,#,#,#,#,#,#, , , ,#,#,#, , , , , , , , , , , , , , , , ,#,#,#,#,
#,#,#,#,#,#,#, , , , , ,#,#,#,#,#,#,#,#,#,#,#,#,#, , , , , , , , , , , , , , , , , , , , , ,#,#,#,#,
#,#,#,#,#,#,#,#, , ,#,#,#,#,#,#,#,#,#,#,#,#,#,#,#,#, , , , , , ,#,#,#,#,#,#, , ,#,#,#, , ,#,#,#,#,#,
#,#,#,#,#,#,#,#,#,#,#,#,#,#,#,#,#,#,#,#,#,#,#,#,#,#,#,#,#,#,#,#,#,#,#,#,#,#,#,#,#,#,#,#,#,#,#,#,#,#,
#,#,#,#,#,#,#,#,#,#,#,#,#,#,#,#,#,#,#,#,#,#,#,#,#,#,#,#,#,#,#,#,#,#,#,#,#,#,#,#,#,#,#,#,#,#,#,#,#,#,
#,#,#,#,#,#,#,#,#,#,#,#,#,#,#,#,#,#,#,#,#,#,#,#,#,#,#,#,#,#,#,#,#,#,#,#,#,#,#,#,#,#,#,#,#,#,#,#,#,#,
