#,#,#,#,#,#,#,#,#,#,#,#,#,#,#,#,#,#,#,#,#,#,#,#,#,#,#,#,#,#,#,#,#,#,#,#,#,#,#,#,#,#,#,#,#,#,#,#,#,#,
#,#,#,#,#,#,#,#,#,#,#,#,#,#,#,#,#,#,#,#,#,#,#,#, , ,#,#, , ,#,#,#,#,#,#,#,#,#,#,#,#,#,#,#,#,#,#,#,#,
#,#,#,#,#,#, , , , ,#,#,#,#,#,#,#,#,#,#,#,#, , , , , , , , , ,#,#,#,#,#,#,#,#,#,#,#,#,#,#,#,#,#,#,#,
#,#,#,#,#, , , , , , , ,#,#,#,#,#,#,#,#,#, , , ,#,#,#, , , , , ,#,#,#,#,#,#,#,#,#,#,#,#,#,#,#,#,#,#,
#,#,#,#,#, , ,#,#,#, , , ,#,#,#,#,#,#,#,#, , ,#,#,#,#,#, , , , ,#,#,#,#,#, , ,#,#,#,#,#,#,#,#,#,#,#,
#,#,#,#, , ,#,#,#,#,#, , , ,#,#,#,#,#,#, , ,#,#,#,#,#,#, , , ,#,#,#,#,#, , , , ,#,#,#,#,#,#,#,#,#,#,
#,#,#,#, , ,#,#,#,#,#,#, , , ,#,#,#,#,#, , ,#,#,#,#,#,#, , , ,#,#,#,#, , , , , ,#,#,#,#,#,#, , ,#,#,
#,#,#,#,#,#,#,#,#,#,#,#, , , ,#,#,#,#,#, , ,#,#,#,#,#,#, , , , ,#,#, , , , , ,#,#,#,#,#,#,#, , ,#,#,
#,#,#,#,#,#,#,#,#,#,#,#, , , ,#,#,#,#,#, , , ,#,#,#,#, , , , , , , , , , , , ,#,#,#,#,#,#,#, , ,#,#,
#,#,#,#,#,#,#,#,#,#,#, , , ,#,#,#,#,#,#,#, , , , , , , , , , , , , , , , , , , ,#,#,#,#,#, , , ,#,#,
#,#,#,#,#,#,#,#,#,#,#, , ,#,#,#,#,#,#,#,#, , , , , , , , , , , , , , , , , , , , , , , , , , , ,#,#,
#,#,#,#,#,#,#,#,#,#, , , ,#,#,#,#,#,#,#,#,#, , ,#,#,#,#, , , , , , , , , , , , , , , , , , , ,#,#,#,
#,#,#,#,#,#,#, , , , , , ,#,#,#,#,#,#,#,#,#,#,#,#,#,#,#,#, , ,#,#,#,#,#, , , , , , ,#,#,#,#,#,#,#,#,
#,#,#,#,#,#, , , , , , ,#,#,#,#,#,#,#,#,#,#,#,#,#,#,#,#,#, ,#,#,#,#,#,#,#, , , , ,#,#,#,#,#,#,#,#,#,
#,#,#,#,#, , , , , , , ,#,#,#,#,#,#,#,#,#,#,#,#,#,#,#,#, , ,#,#,#,#,#,#,#, , , , ,#,#,#,#,#,#,#,#,#,
#,#,#,#, , , , , , , , ,#,#,#,#,#,#,#,#,#,#,#,#,#,#,#,#, , ,#,#,#,#,#,#,#, , , , ,#,#,#,#,#,#,#,#,#,
#,#,#, , , ,#,#, , , ,#,#,#,#,#,#,#,#,#,#,#,#,#,#,#,#, , ,#,#,#,#,#,#,#,#, , , ,#,#,#,#,#,#,#,#,#,#,
#,#,#, , ,#,#,#,#, , ,#,#,#,#,#,#,#,#,#,#,#,#,#,#,#,#, , ,#,#,#,#,#,#,#,#, , ,#,#,#,#,#,#,#,#,#,#,#,
#,#,#, ,#,#,#,#,#,#, , ,#,#,#,#,#,#,#,#,#,#,#,#,#,#,#, , , ,#,#,#,#,#,#,#, , ,#,#,#,#,#,#,#,#,#,#,#,
#,#, , ,#,#,#,#,#,#, , , ,#,#,#,#,#,#,#,#,#,#,#,#,#, , , , , ,#,#,#,#,#, , , , ,#,#,#,#,#,#,#,#,#,#,
#,#, , ,#,#,#,#,#,#,#, , , , , , , ,#,#,#,#,#,#,#, , , , , , ,#,#,#,#,#, , , , , ,#,#,#,#,#,#,#,#,#,
#,#, , , ,#,#,#,#,#,#, , , , , , , , , , , , , , , , , , , ,#,#,#,#,#, , , , , , , , , ,#,#,#,#,#,#,
#,#,#, , , ,#,#,#,#,#, , , , , , , , , , , , , , , , , , ,#,#,#,#,#,#, , , , , , , , , , ,#,#,#,#,#,
#,#,#,#, , , ,#,#,#, , , , , , , , ,#,#,#,#,#, , , , , ,#,#,#,#,#,#,#,#, , , , , , , , , , ,#,#,#,#,
#,#,#,#,#, , , , , , , , , , , , ,#,#,#,#,#,#,#, , , ,#,#,#,#,#,#,#,#,#, , , , ,#,#, , , , , ,#,#,#,
#,#,#,#,#,#, , , , , , , , , , , ,#,#,#,#,#,#,#, , , ,#,#,#,#,#,#,#,#,#, , , ,#,#,#,#, , , , ,#,#,#,
#,#,#,#,#,#,#,#,#,#, , , , , , , ,#,#,#,#,#,#,#, , ,#,#,#,#,#,#,#,#,#,#, , ,#,#,#,#,#,#, , , ,#,#,#,
#,#,#,#,#,#,#,#,#,#,#, , , , , , , ,#,#,#,#,#,#, ,#,#,#,#,#,#,#,#,#,#,#, , ,#,#,#,#,#,#,#, , ,#,#,#,
#,#,#,#,#,#,#,#,#,#,#,#, ,#,#,#, , , ,#,#,#,#, , ,#,#,#,#,#,#,#,#,#,#,#,#, , ,#,#,#,#,#,#, , ,#,#,#,
#,#,#,#,#,#,#,#,#,#,#,#,#,#,#,#,#, , , ,#,#, , , ,#,#,#,#,#,#,#,#,#,#,#,#, , ,#,#,#,#,#, , , ,#,#,#,
#,#,#,#,#,#,#,#,#,#,#,#,#,#,#,#,#,#, , , , , , ,#,#,#,#,#,#,#,#,#,#,#,#,#, , ,#,#,#,#, , , ,#,#,#,#,
#,#,#,#,#,#,#,#,#,#,#,#,#,#,#,#,#,#,#, , , , , ,#,#,#,#,#,#,#,#,#,#,#,#, , , , ,#,#, , , ,#,#,#,#,#,
#,#,#,#,#,#,#,#,#,#,#,#,#,#,#,#,#,#,#,#, , , , , ,#,#,#,#,#,#,#,#,#,#,#, , , , , , , , , ,#,#,#,#,#,
#,#,#,#,#,#,#,#,#,#,#,#,#,#,#,#,#,#,#,#,#, , , , , ,#,#,#,#,#,#,#,#,#,#, , , , , , , , , ,#,#,#,#,#,
#,#,#,#, , , , ,#,#,#,#,#,#,#,#,#,#,#,#,#, , , , , , ,#,#,#,#,#,#,#,#,#,#, , , , , , , , ,#,#,#,#,#,
#,#, , , , , , , , , , ,#,#,#,#,#,#,#,#, , , , , , , , ,#,#,#,#,#,#,#,#,#, , , , , , , , ,#,#,#,#,#,
#, , , , ,#,#,#,#, , , , ,#,#,#,#,#, , , , ,#,#,#, , , ,#,#,#,#,#,#,#,#, , , , , , , , , ,#,#,#,#,#,
#, , , ,#,#,#,#,#,#, , , , ,#,#,#, , , , ,#,#,#,#,#, , ,#,#,#,#,#,#, , , , , , , , , , , ,#,#,#,#,#,
#, , , ,#,#,#,#,#,#,#, , , , , , , , ,#,#,#,#,#,#,#, , ,#,#,#,#,#, , , , , , ,#,#, , , , , ,#,#,#,#,
#,#, , ,#,#,#,#,#,#,#, , , , , , , ,#,#,#,#,#,#,#,#, , ,#,#,#,#,#, , , , , ,#,#,#,#, , , , ,#,#,#,#,
#,#,#, , ,#,#,#,#,#, , , , , , , ,#,#,#,#,#,#,#,#,#, , ,#,#,#,#,#, , , , ,#,#,#,#,#, , , , ,#,#,#,#,
#,#,#,#, , ,#,#,#, , , , , , , , ,#,#,#,#,#,#,#,#, , , ,#,#,#,#,#,#, , , ,#,#,#,#,#, , , , ,#,#,#,#,
#,#,#,#,#, , , , , , ,#,#,#, , , , ,#,#,#,#,#,#,#, , , ,#,#,#,#,#,#, , , ,#,#,#,#,#, , , ,#,#,#,#,#,
#,#,#,#,#,#, , , , ,#,#,#,#,#,#, , , , ,#,#,#,#, , , ,#,#,#,#,#,#, , , , ,#,#,#,#,#, , ,#,#,#,#,#,#,
#,#,#,#,#,#,#, , ,#,#,#,#,#,#,#,#, , , , , , , , , ,#,#,#,#,#,#, , , , , , ,#,#,#, , , ,#,#,#,#,#,#,
#,#,#,#,#,#,#,#,#,#,#,#,#,#,#,#,#, , , , , , , , ,#,#,#,#,#,#,#, , , , , , , , , , , , ,#,#,#,#,#,#,
#,#,#,#,#,#,#,#,#,#,#,#,#,#,#,#,#, , , , , , , ,#,#,#,#,#,#,#,#,#, , ,#,#, , , , , , ,#,#,#,#,#,#,#,
#,#,#,#,#,#,#,#,#,#,#,#,#,#,#,#,#,#, , , , , ,#,#,#,#,#,#,#,#,#,#,#,#,#,#,#,#, , , ,#,#,#,#,#,#,#,#,
#,#,#,#,#,#,#,#,#,#,#,#,#,#,#,#,#,#,#, , , ,#,#,#,#,#,#,#,#,#,#,#,#,#,#,#,#,#,#,#,#,#,#,#,#,#,#,#,#,
#,#,#,#,#,#,#,#,#,#,#,#,#,#,#,#,#,#,#,#,#,#,#,#,#,#,#,#,#,#,#,#,#,#,#,#,#,#,#,#,#,#,#,#,#,#,#,#,#,#,
