#,#,#,#,#,#,#,#,#,#,#,#,#,#,#,#,#,#,#,#,#,#,#,#,#,#,#,#,#,#,#,#,#,#,#,#,#,#,#,#,#,#,#,#,#,#,#,#,#,#,
#,#,#,#,#,#,#,#,#,#,#,#,#,#,#,#,#,#,#,#,#,#, , , , , , , ,#,#,#,#,#,#,#,#,#,#,#,#,#,#,#,#,#,#,#,#,#,
#,#,#,#, , , , , , ,#,#,#,#,#,#,#,#,#,#,#, , , , , , , , , , ,#,#,#,#,#,#,#,#,#,#,#,#,#,#,#,#,#,#,#,
#,#,#, , , , , , , , ,#,#,#,#,#,#,#,#,#, , , , ,#,#,#,#,#, , , , , ,#,#,#,#,#,#,#,#,#,#,#,#,#,#,#,#,
#,#, , , , ,#,#,#, , , ,#,#,#,#,#,#,#,#, , , ,#,#,#,#,#,#,#, , , , , , , ,#,#,#,#,#,#,#, ,#,#,#,#,#,
#,#, , , ,#,#,#,#,#, , ,#,#,#,#,#,#,#,#, , , ,#,#,#,#,#,#,#, , , , , , , , ,#,#,#,#,#, , , ,#,#,#,#,
#,#, , , ,#,#,#,#,#,#,#,#,#,#,#,#,#,#,#, , , ,#,#,#,#,#,#, , , , , , , , , ,#,#,#,#,#, , , ,#,#,#,#,
#,#, , , ,#,#,#,#,#,#,#,#,#,#,#,#,#,#,#,#, , ,#,#,#,#,#, , , , , , , , , , , ,#,#,#,#, , , , ,#,#,#,
#,#,#, , ,#,#,#,#,#,#,#,#,#,#,#,#,#,#,#,#, , , ,#,#, , , , ,#,#,#,#,#,#, , , , ,#,#, , , , , ,#,#,#,
#,#,#, , ,#,#,#,#,#,#,#,#,#,#,#,#,#,#,#, , , , , , , , , ,#,#,#,#,#,#,#,#, , , , , , , , , , ,#,#,#,
#,#,#,#, , ,#,#,#,#,#,#,#,#,#,#,#,#,#,#, , , , , , , ,#,#,#,#,#,#,#,#,#,#, , , , , , , , , ,#,#,#,#,
#,#,#,#, , ,#,#,#,#,#,#,#,#,#,#,#,#,#, , , , , , , ,#,#,#,#,#,#,#,#,#,#,#, , , , , , , , , ,#,#,#,#,
#,#,#,#,#, , ,#,#,#,#,#,#,#,#,#,#,#, , , ,#,#, , , ,#,#,#,#,#,#,#,#,#,#,#, , , , , , , , , , ,#,#,#,
#,#,#,#,#,#, , , , , ,#,#,#,#,#,#,#, , ,#,#,#,#, , , ,#,#,#,#,#,#,#,#,#,#, , , , ,#,#,#, , , ,#,#,#,
#,#,#,#,#,#, , , , , , ,#,#,#,#,#,#, , ,#,#,#,#,#, , ,#,#,#,#,#,#,#,#,#,#, , , ,#,#,#,#,#, , , ,#,#,
#,#,#,#,#,#, , , , , ,#,#,#,#,#,#, , ,#,#,#,#,#,#, , ,#,#,#,#,#,#,#,#,#,#, , ,#,#,#,#,#,#,#, , ,#,#,
#,#,#,#,#,#, , , , , ,#,#,#,#,#,#, , ,#,#,#,#,#,#, , ,#,#,#,#,#,#,#,#,#,#, , ,#,#,#,#,#,#,#, , ,#,#,
#,#,#,#,#,#, , , , , , ,#,#,#,#, , , ,#,#,#,#,#,#, , ,#,#,#,#,#,#,#,#,#,#, , ,#,#,#,#,#,#, , , ,#,#,
#,#,#,#,#, , , ,#,#, , , ,#,#, , , , ,#,#,#,#,#,#, , ,#,#,#,#,#,#,#,#,#,#, , ,#,#,#,#,#,#, , ,#,#,#,
#,#,#,#, , , ,#,#,#,#, , , , , , , , , ,#,#,#,#, , , ,#,#,#,#,#,#,#,#,#, , , , ,#,#,#,#, , , ,#,#,#,
#,#,#, , , ,#,#,#,#,#,#, , , , , , , , , , , , , , , ,#,#,#,#,#,#,#,#,#, , , , , ,#,#, , , , ,#,#,#,
#,#, , , ,#,#,#,#,#,#,#, , , , , , , , , , , , , , ,#,#,#,#,#,#,#,#,#,#, , , , , , , , , , , ,#,#,#,
#,#, , , ,#,#,#,#,#,#,#, , , ,#,#,#,#,#, , , , ,#,#,#,#,#,#,#,#,#,#,#, , , , , , , , , , , , ,#,#,#,
#,#,#, ,#,#,#,#,#,#,#,#, , ,#,#,#,#,#,#,#, , ,#,#,#,#,#,#,#,#,#,#, , , , , , , , , , , , , ,#,#,#,#,
#,#,#,#,#,#,#,#,#,#,#, , ,#,#,#,#,#,#,#,#,#,#,#,#,#,#,#,#,#,#,#, , , , , ,#,#, , , , , , ,#,#,#,#,#,
#,#,#,#,#,#,#,#,#,#, , , ,#,#,#,#,#,#,#,#,#,#,#,#,#,#,#,#,#,#, , , , ,#,#,#,#,#, , , , , ,#,#,#,#,#,
#,#,#,#,#,#,#,#, , , , ,#,#,#,#,#,#,#,#,#,#,#,#,#,#,#,#,#,#,#, , , ,#,#,#,#,#,#,#, , , , ,#,#,#,#,#,
#,#,#,#,#,#,#, , , , , ,#,#,#,#,#,#,#,#,#,#,#,#,#,#,#,#,#,#,#, , , ,#,#,#,#,#,#,#, , , ,#,#,#,#,#,#,
#,#,#,#,#,#,#, , , , , ,#,#,#,#,#,#,#,#,#,#,#,#,#,#,#,#,#,#,#,#, , ,#,#,#,#,#,#,#, , ,#,#,#,#,#,#,#,
#,#,#,#,#,#,#, , , , , ,#,#,#,#,#,#,#,#,#,#,#,#,#,#,#,#,#,#,#,#, , ,#,#,#,#,#,#, , , ,#,#,#,#,#,#,#,
#,#,#,#,#,#, , , , , , ,#,#,#,#,#,#,#,#,#,#,#,#,#,#,#,#,#,#,#,#,#, , ,#,#,#,#,#, , , ,#,#,#,#,#,#,#,
#,#,#,#,#, , , , , , ,#,#,#,#,#,#,#,#,#,#, , ,#,#,#,#,#,#,#,#,#,#,#, , , ,#,#,#, , , , ,#,#,#,#,#,#,
#,#,#,#, , , , , , , ,#,#,#,#,#,#,#,#,#, , , , ,#,#,#,#,#,#,#,#,#,#,#, , , ,#,#,#, , ,#,#,#,#,#,#,#,
#,#,#, , , , , , , , ,#,#,#,#,#,#,#,#, , , , , , ,#,#,#,#,#,#,#,#,#,#,#, , ,#,#,#,#,#,#,#,#,#,#,#,#,
#,#,#, , , , , , , , ,#,#,#,#,#,#,#,#, , , , , , , ,#,#,#,#,#,#,#,#,#,#, , , ,#,#,#,#,#,#,#,#,#,#,#,
#,#, , , , , , , , , ,#,#,#,#,#,#,#,#, , , , , , , , ,#,#,#,#,#,#,#,#,#, , , , , , ,#,#,#,#,#,#,#,#,
#, , , , , , ,#,#, , , ,#,#,#,#,#,#, , , , , , , , , , , ,#,#,#,#,#,#,#, , , , , , , ,#,#,#,#,#,#,#,
#, , , , , ,#,#,#,#, , , , , , , , , , , , ,#,#,#, , , , , ,#,#,#,#,#,#, , , , , , , , , ,#,#,#,#,#,
#,#, , , ,#,#,#,#,#,#, , , , , , , , , , ,#,#,#,#,#, , , , ,#,#,#,#,#, , , , , , , , , , , ,#,#,#,#,
#,#,#, , ,#,#,#,#,#,#, , , , , , , , , , ,#,#,#,#,#, , , , ,#,#,#,#, , , , , , ,#,#,#, , , ,#,#,#,#,
#,#,#, , , ,#,#,#,#, , , , , , , , , , , ,#,#,#,#,#, , , , ,#,#,#,#, , , , , ,#,#,#,#,#, , , ,#,#,#,
#,#,#,#, , , ,#,#, , , , , , , ,#,#,#, , , ,#,#,#, , , , ,#,#,#,#,#, , , , ,#,#,#,#,#,#, , , ,#,#,#,
#,#,#,#,#, , , , , , ,#,#,#,#,#,#,#,#,#, , , , , , , , , ,#,#,#,#,#,#, , , ,#,#,#,#,#,#, , , ,#,#,#,
#,#,#,#,#, , , , , ,#,#,#,#,#,#,#,#,#,#, , , , , , , , ,#,#,#,#,#,#,#,#, , , ,#,#,#,#, , , , ,#,#,#,
#,#,#,#,#, , , , , ,#,#,#,#,#,#,#,#,#,#,#, , , ,#,#,#,#,#,#,#,#,#,#,#,#,#, , , , , , , , , ,#,#,#,#,
#,#,#,#,#,#, , , ,#,#,#,#,#,#,#,#,#,#,#,#,#,#,#,#,#,#,#,#,#,#,#,#,#,#,#,#,#,#, , , , , ,#,#,#,#,#,#,
#,#,#,#,#,#,#,#,#,#,#,#,#,#,#,#,#,#,#,#,#,#,#,#,#,#,#,#,#,#,#,#,#,#,#,#,#,#,#,#,#, , ,#,#,#,#,#,#,#,
#,#,#,#,#,#,#,#,#,#,#,#,#,#,#,#,#,#,#,#,#,#,#,#,#,#,#,#,#,#,#,#,#,#,#,#,#,#,#,#,#,#,#,#,#,#,#,#,#,#,
#,#,#,#,#,#,#,#,#,#,#,#,#,#,#,#,#,#,#,#,#,#,#,#,#,#,#,#,#,#,#,#,#,#,#,#,#,#,#,#,#,#,#,#,#,#,#,#,#,#,
#,#,#,#,#,#,#,#,#,#,#,#,#,#,#,#,#,#,#,#,#,#,#,#,#,#,#,#,#,#,#,#,#,#,#,#,#,#,#,#,#,#,#,#,#,#,#,#,#,#,
