#,#,#,#,#,#,#,#,#,#,#,#,#,#,#,#,#,#,#,#,#,#,#,#,#,#,#,#,#,#,#,#,#,#,#,#,#,#,#,#,#,#,#,#,#,#,#,#,#,#,
#,#,#,#,#,#,#,#,#,#,#,#,#,#,#,#,#,#,#, , ,#,#,#,#,#,#,#,#,#,#,#,#,#,#,#,#,#,#,#,#,#,#,#,#,#,#,#,#,#,
#,#, , , , ,#,#,#,#,#,#,#,#,#,#,#, , , , , ,#,#,#,#,#,#,#,#,#,#,#,#,#,#,#,#,#, , , , ,#,#,#,#,#,#,#,
#, , , , , , ,#,#,#, ,#,#,#,#, , , , ,#,#, , , ,#,#,#,#,#,#,#,#,#,#,#,#,#,#, , , , , , ,#,#,#,#,#,#,
#, , , , , , , , , , , ,#,#, , , , ,#,#,#,#, , , ,#,#,#,#,#,#,#,#,#,#,#,#, , , , , , , ,#,#,#,#,#,#,
#, , , ,#,#, , , , , ,#,#,#, , , ,#,#,#,#,#,#, , ,#,#,#,#,#,#,#,#,#,#,#, , , ,#,#, , , ,#,#,#,#,#,#,
#, , ,#,#,#,#, , , , , ,#, , , , ,#,#,#,#,#,#, , ,#,#,#,#,#,#,#,#,#,#,#, , ,#,#,#,#, , , ,#,#,#,#,#,
#, , ,#,#,#,#,#, , , , , , , , , ,#,#,#,#,#, , ,#,#,#,#,#,#,#,#,#,#,#, , , ,#,#,#,#,#, , ,#,#,#,#,#,
#, , ,#,#,#,#,#, , , , , , , , , , ,#,#,#, , , ,#,#,#,#,#,#,#,#,#,#,#, , , ,#,#,#,#,#, , ,#,#,#,#,#,
#, , ,#,#,#,#,#, , , ,#,#,#,#,#,#, , , , , , , ,#,#,#,#,#,#,#,#,#,#, , , , , ,#,#,#, , ,#,#,#,#,#,#,
#, , , ,#,#,#, , , ,#,#,#,#,#,#,#,#, , , , , ,#,#,#,#,#,#,#,#,#,#,#, , , , , , , , , , ,#,#,#,#,#,#,
#,#, , , , , , , , ,#,#,#,#,#,#,#,#,#, , , ,#,#,#,#,#,#,#,#,#,#,#, , , , , , , , , , ,#,#,#,#,#,#,#,
#,#,#, , , , , , , , ,#,#,#,#,#,#,#,#,#,#,#,#,#,#,#,#,#,#,#, , , , , , , , , , , , , ,#,#,#,#,#,#,#,
#,#,#, , , , , , , , ,#,#,#,#,#,#,#,#,#,#,#,#,#,#,#,#,#,#, , , , , , , , , , , , , ,#,#,#,#,#,#,#,#,
#,#,#, , , , , , , , , ,#,#,#,#,#,#,#,#,#,#,#,#,#,#,#,#, , , , , , , , , , , , , , ,#,#,#,#,#,#,#,#,
#,#,#,#, , , , , , , , , ,#,#,#,#,#,#,#,#,#,#,#,#,#,#, , , ,#,#,#,#, , , , , , , , ,#,#,#,#,#,#,#,#,
#,#,#,#,#, , , , , , , , ,#,#,#,#,#,#,#,#,#,#,#,#,#, , , ,#,#,#,#,#,#, , , , , , ,#,#,#,#,#,#,#,#,#,
#,#,#,#,#, , , , , , , , ,#,#,#,#,#,#,#,#,#,#,#,#,#, , ,#,#,#,#,#,#,#, , , ,#,#,#,#,#,#,#,#,#,#,#,#,
#,#,#,#,#, , , , , , , , ,#,#,#,#,#,#,#,#,#,#,#,#, , , ,#,#,#,#,#,#,#, , ,#,#,#,#,#,#,#,#,#,#,#,#,#,
#,#,#,#, , , ,#,#, , , , ,#,#,#,#,#,#,#,#,#,#,#, , , ,#,#,#,#,#,#,#,#, , ,#,#,#,#,#,#,#,#,#,#,#,#,#,
#,#,#, , , ,#,#,#,#, , , ,#,#,#,#,#,#,#,#,#,#,#, , , ,#,#,#,#,#,#,#,#, , ,#,#,#,#,#,#,#,#,#,#,#,#,#,
#,#,#, , , ,#,#,#,#,#, , ,#,#,#,#,#,#,#,#,#,#,#, , , , ,#,#,#,#,#,#, , , ,#,#,#,#,#,#,#,#,#,#,#,#,#,
#,#,#, , , ,#,#,#,#,#,#, , ,#,#,#,#,#,#,#,#,#, , , , , , , , , , , , , , , ,#,#,#, , ,#,#,#,#,#,#,#,
#,#,#,#, , ,#,#,#,#,#,#,#, , , , ,#,#,#,#,#, , , ,#, , , , , , , , , , , , , , , , , , , , ,#,#,#,#,
#,#,#,#, , , ,#,#,#,#,#,#,#, , , , , , , , , , , ,#, , , ,#,#,#,#,#, , , , , , , , , , , , , ,#,#,#,
#,#,#,#, , , , , , ,#,#,#,#,#,#,#, , , , , , , , , , , ,#,#,#,#,#,#,#,#, , , , ,#,#,#,#,#, ,#,#,#,#,
#,#,#,#,#, , , , , , , , , ,#,#,#,#,#,#,#,#,#, , , , ,#,#,#,#,#,#,#,#,#,#, , ,#,#,#,#,#,#,#,#,#,#,#,
#,#,#,#,#,#,#, , , , , , , , , ,#,#,#,#,#,#,#,#, , , ,#,#,#,#,#,#,#,#,#,#, , ,#,#,#,#,#,#,#,#,#,#,#,
#,#,#,#,#,#,#,#, , , , ,#,#, , , ,#,#,#,#,#,#,#, , , ,#,#,#,#,#,#,#,#,#,#, , ,#,#,#,#,#,#,#,#,#,#,#,
#,#,#,#,#,#,#,#,#, , ,#,#,#,#, , ,#,#,#,#,#,#,#, , , ,#,#,#,#,#,#,#,#,#, , , ,#,#,#,#,#,#,#,#,#,#,#,
#,#,#,#,#,#,#,#,#,#,#,#,#,#,#,#, , ,#,#,#,#,#,#, , , ,#,#,#,#,#,#,#,#,#, , , , ,#,#,#,#,#,#,#,#,#,#,
#,#,#,#,#,#,#,#,#,#,#,#,#,#,#,#, , , ,#,#,#,#,#, , ,#,#,#,#,#,#,#,#,#,#,#, , , , ,#,#,#, ,#,#,#,#,#,
#,#,#,#,#,#,#,#,#,#,#,#,#,#,#,#,#, , , ,#,#,#,#, , ,#,#,#,#,#,#,#,#,#,#,#,#,#, , , , , , , ,#,#,#,#,
#,#,#,#,#, , ,#,#,#,#,#,#,#,#,#,#,#, , , ,#,#, , , ,#,#,#,#,#,#,#,#,#,#,#,#,#,#, , , , , ,#,#,#,#,#,
#,#,#,#, , , , ,#,#,#,#,#,#,#,#,#,#, , , ,#,#, , , ,#,#,#,#,#,#,#,#,#,#,#,#,#,#, , , , ,#,#,#,#,#,#,
#,#,#, , , , , , ,#,#,#,#,#,#,#,#,#, , , , , , , , ,#,#,#,#,#,#,#,#,#,#,#,#,#, , , ,#,#,#,#,#,#,#,#,
#,#, , , , , , , , , ,#,#,#,#,#,#,#, , , , , , , , ,#,#,#,#,#,#,#,#,#,#,#,#,#, , ,#,#,#,#,#,#,#,#,#,
#, , , ,#,#,#,#,#, , , ,#,#,#,#,#, , , , , , , , , ,#,#,#,#,#,#,#,#,#,#,#,#, , , , ,#, , ,#,#,#,#,#,
#, , ,#,#,#,#,#,#,#, , , ,#,#,#, , , , , , , , , , ,#,#,#,#,#,#,#,#,#,#,#,#, , , , , , , , ,#,#,#,#,
#, , ,#,#,#,#,#,#,#,#, , , , , , , , , ,#,#,#,#, , , ,#,#,#,#,#,#,#,#,#,#, , , , , , , , , , ,#,#,#,
#, , ,#,#,#,#,#,#,#,#,#, , , , , , , ,#,#,#,#,#,#, , ,#,#,#,#,#,#, , , , , , , , , , , , , , ,#,#,#,
#, , , ,#,#,#,#,#,#,#,#, , , , , , ,#,#,#,#,#,#,#, , ,#,#,#,#,#, , , , , , ,#,#,#, , , , , , ,#,#,#,
#,#, , , ,#,#,#,#,#,#, , , , , , , ,#,#,#,#,#,#,#, , ,#,#,#,#,#, , , , , ,#,#,#,#,#, , , , ,#,#,#,#,
#,#,#, , , , ,#,#, , , , , , , , , , ,#,#,#,#,#, , ,#,#,#,#,#,#,#, , , ,#,#,#,#,#,#, , , ,#,#,#,#,#,
#,#,#,#,#, , , , , , , , , ,#,#,#, , , ,#,#,#,#, , ,#,#,#,#,#,#,#,#, , ,#,#,#,#,#,#, , , ,#,#,#,#,#,
#,#,#,#,#,#, , , , , , , ,#,#,#,#,#, , , ,#,#, , ,#,#,#,#,#,#,#,#,#, , ,#,#,#,#,#, , , , ,#,#,#,#,#,
#,#,#,#,#,#,#, , , , , ,#,#,#,#,#,#,#, , , , , , ,#,#,#,#,#,#,#,#,#, , , ,#,#,#, , , , , ,#,#,#,#,#,
#,#,#,#,#,#,#,#,#,#,#,#,#,#,#,#,#,#,#,#, , , , ,#,#,#,#,#,#,#,#,#,#,#, , , , , , , , , ,#,#,#,#,#,#,
#,#,#,#,#,#,#,#,#,#,#,#,#,#,#,#,#,#,#,#,#,#,#,#,#,#,#,#,#,#,#,#,#,#,#,#, , , , ,#,#,#,#,#,#,#,#,#,#,
#,#,#,#,#,#,#,#,#,#,#,#,#,#,#,#,#,#,#,#,#,#,#,#,#,#,#,#,#,#,#,#,#,#,#,#,#,#,#,#,#,#,#,#,#,#,#,#,#,#,
