#,#,#,#,#,#,#,#,#,#,#,#,#,#,#,#,#,#,#,#,#,#,#,#,#,#,#,#,#,#,#,#,#,#,#,#,#,#,#,#,#,#,#,#,#,#,#,#,#,#,
#,#,#,#,#, , , , ,#,#,#,#,#,#,#,#,#,#,#,#,#,#,#,#,#,#,#,#,#,#,#,#,#,#,#,#,#,#,#,#,#,#,#,#,#,#,#,#,#,
#,#,#,#, , , , , ,#,#,#,#,#,#,#,#,#,#,#,#,#,#,#,#,#,#,#,#,#,#,#,#,#,#,#,#,#,#,#,#,#,#,#,#,#,#,#,#,#,
#,#,#, , , , ,#,#,#,#,#,#,#,#,#,#,#,#,#,#,#,#,#,#, , , , ,#,#,#,#,#,#,#,#,#,#,#,#,#,#,#,#,#,#,#,#,#,
#,#,#, , , ,#,#,#,#,#,#,#,#,#,#,#,#,#,#,#,#,#, , , , , , , , ,#,#,#,#, , ,#,#,#, , , , ,#,#,#,#,#,#,
#,#,#, , , ,#,#,#,#,#,#,#,#,#,#,#,#,#,#,#,#, , , ,#,#,#,#, , , , , , , , , , , , , , , , ,#,#,#,#,#,
#,#,#,#, , , ,#,#,#,#, , ,#,#,#,#,#,#,#,#,#, , ,#,#,#,#,#,#, , , , , , , , , , ,#,#,#, , , ,#,#,#,#,
#,#,#,#,#, , , , , , , , , ,#,#,#,#,#,#,#,#, , ,#,#,#,#,#,#,#, , , , , , , ,#,#,#,#,#,#, , ,#,#,#,#,
#,#,#,#,#, , , , , , , , ,#,#,#,#,#,#,#,#,#, , , ,#,#,#,#,#,#, , , , , , ,#,#,#,#,#,#,#, , , ,#,#,#,
#,#,#,#,#, , , , , , , , ,#,#,#,#,#,#,#,#, , , , ,#,#,#,#,#, , , , , , , ,#,#,#,#,#,#,#, , , ,#,#,#,
#,#,#,#, , , , ,#,#,#, , , ,#,#, , ,#,#, , , , , , ,#,#,#, , , , , , , , , ,#,#,#,#,#,#, , , ,#,#,#,
#,#,#,#, , , ,#,#,#,#,#, , , , , , , , , , , , , , ,#,#, , , , , , , , , , , ,#,#,#,#, , , ,#,#,#,#,
#,#,#,#,#, ,#,#,#,#,#,#, , , , , , , , , , , , , ,#,#,#,#, , ,#,#,#, , , , , , ,#,#, , , , ,#,#,#,#,
#,#,#,#,#,#,#,#,#,#,#,#,#, , , ,#,#,#,#,#, , , ,#,#,#,#,#,#,#,#,#,#,#, , , , , , , , , , , ,#,#,#,#,
#,#,#,#,#,#,#,#,#,#,#,#,#, , ,#,#,#,#,#,#,#, , ,#,#,#,#,#,#,#,#,#,#,#, , , , , , , , , , ,#,#,#,#,#,
#,#,#,#, , , , ,#,#,#,#, , , ,#,#,#,#,#,#,#, , ,#,#,#,#,#,#,#,#,#,#,#,#, , , , , , , , ,#,#,#,#,#,#,
#,#,#, , , , , , , , , , , , ,#,#,#,#,#,#,#, , ,#,#,#,#,#,#,#,#,#,#,#,#,#,#, , , , , , ,#,#,#,#,#,#,
#,#, , ,#,#,#, , , , , , , , ,#,#,#,#,#,#,#, , ,#,#,#,#,#,#,#,#,#,#,#,#,#,#,#, , , , , ,#,#,#,#,#,#,
#, , ,#,#,#,#,#, , , , , , , , ,#,#,#,#,#,#, , ,#,#,#,#,#,#,#,#,#,#,#,#,#,#,#,#, , , , , ,#,#,#,#,#,
#, , ,#,#,#,#,#,#, , , , , , , , ,#,#,#,#, , , ,#,#,#,#,#,#,#,#,#,#,#,#,#,#,#,#, , , , , , ,#,#,#,#,
#,#, , ,#,#,#,#,#, , , , , , , , , , , , , , ,#,#,#,#,#,#,#,#,#,#,#,#,#,#,#,#, , , , , , , , ,#,#,#,
#,#, , ,#,#,#,#,#, , , , , ,#,#,#,#, , , , , ,#,#,#,#,#, ,#,#,#,#,#,#,#,#,#, , , ,#,#, , , , ,#,#,#,
#,#, , , ,#,#,#, , , , , ,#,#,#,#,#,#, , , , , ,#,#,#, , , ,#,#,#,#,#,#,#, , , ,#,#,#,#, , , ,#,#,#,
#,#,#, , , , , , , , , ,#,#,#,#,#,#,#,#, , , , , , , , , , ,#,#,#,#,#,#,#, , ,#,#,#,#,#, , , ,#,#,#,
#,#,#,#, , , , , , , ,#,#,#,#,#,#,#,#,#,#, , , , , , , , , ,#,#,#,#,#,#,#, , ,#,#,#,#,#, , ,#,#,#,#,
#,#,#,#,#,#,#,#,#,#,#,#,#,#,#,#,#,#,#,#,#,#,#,#,#, , , , , ,#,#,#,#,#,#,#,#, ,#,#,#,#,#, , ,#,#,#,#,
#,#,#,#,#,#,#,#,#,#,#,#,#,#,#,#,#,#,#,#,#,#,#,#,#,#,#, , , ,#,#,#,#,#,#,#,#, , ,#,#,#, , ,#,#,#,#,#,
#,#,#,#,#,#,#,#,#,#,#,#,#,#,#,#,#,#,#,#,#,#,#,#,#,#,#,#, , ,#,#,#,#,#,#,#,#, , , , , , , ,#,#,#,#,#,
#,#,#,#,#,#,#,#,#,#,#,#,#,#,#,#,#,#,#,#,#,#,#,#,#,#,#,#, , ,#,#,#,#,#,#,#,#,#, , , , , ,#,#,#,#,#,#,
#,#,#,#,#,#,#,#,#,#,#,#,#,#,#,#,#,#,#,#,#,#,#,#,#,#,#, , , ,#,#,#,#,#,#,#,#,#, , , , , ,#,#,#,#,#,#,
#,#,#,#,#,#,#,#,#,#,#,#,#,#,#,#,#,#,#,#,#,#,#,#,#,#,#, , , ,#,#,#,#,#,#,#,#,#, , , , , ,#,#,#,#,#,#,
#,#,#,#,#,#,#,#,#,#,#,#,#,#,#,#,#,#,#,#,#, , ,#,#,#, , , ,#,#,#,#,#,#,#,#,#, , , , , ,#,#,#,#,#,#,#,
#,#,#,#,#, , , ,#,#,#,#,#,#,#,#,#,#,#,#,#, , , , , , , ,#,#,#,#,#,#,#,#,#,#, , , , , ,#,#,#,#,#,#,#,
#,#,#, , , , , , ,#,#,#,#,#,#,#,#,#,#,#,#, , , , , , , ,#,#,#,#,#,#,#,#,#,#, , , , , , ,#,#,#,#,#,#,
#,#, , , , , , , , , , ,#,#,#,#,#,#,#,#,#, , , , , , ,#,#,#,#,#,#,#,#,#,#,#, , , , , , ,#,#,#,#,#,#,
#, , , ,#,#,#,#, , , , , ,#,#,#,#,#,#,#, , , , , , ,#,#,#,#,#,#,#,#,#,#,#, , , , , , , ,#,#,#,#,#,#,
#, , ,#,#,#,#,#,#, , , , ,#,#,#,#,#,#,#, , , ,#,#,#,#,#,#,#,#,#,#,#,#,#, , , , , , , , ,#,#,#,#,#,#,
#, , ,#,#,#,#,#,#,#, , , ,#,#,#,#,#,#, , , , , ,#,#,#,#,#,#,#,#,#,#,#, , , , , , , , , ,#,#,#,#,#,#,
#,#, , ,#,#,#,#,#,#, , , , ,#,#,#,#, , , , , , ,#,#,#,#,#,#,#,#,#,#, , , , , , , , , , ,#,#,#,#,#,#,
#,#, , , ,#,#,#,#,#, , , , , , , , , , , , , , ,#,#,#,#,#,#,#,#,#,#, , , , ,#,#,#, , , ,#,#,#,#,#,#,
#,#, , , , ,#,#,#, , , , , , , , ,#,#,#,#, , , ,#,#,#,#,#,#,#,#,#,#,#, , ,#,#,#,#,#, , ,#,#,#,#,#,#,
#,#, , , , , , , , , , , , , , ,#,#,#,#,#,#, , , ,#,#,#,#,#,#,#,#,#,#, , ,#,#,#,#,#, , ,#,#,#,#,#,#,
#,#,#, , , , , , , , ,#,#, , , ,#,#,#,#,#,#, , , , ,#,#,#,#,#,#,#,#,#, , ,#,#,#,#,#, , ,#,#,#,#,#,#,
#,#,#,#,#,#,#,#,#,#,#,#,#,#, , ,#,#,#,#,#,#, , , , ,#,#,#,#,#,#,#,#,#,#, , ,#,#,#, , , ,#,#,#,#,#,#,
#,#,#,#,#,#,#,#,#,#,#,#,#,#,#, , ,#,#,#,#,#, , , , ,#,#,#,#,#,#,#,#,#,#, , , , , , , , , ,#,#,#,#,#,
#,#,#,#,#,#,#,#,#,#,#,#,#,#,#, , , ,#,#,#, , , , ,#,#,#,#,#,#,#,#,#,#,#,#, , , , , , , , ,#,#,#,#,#,
#,#,#,#,#,#,#,#,#,#,#,#,#,#,#,#, , , , , , , , , ,#,#,#,#,#,#,#,#,#,#,#,#,#, , , ,#,#, , ,#,#,#,#,#,
#,#,#,#,#,#,#,#,#,#,#,#,#,#,#,#,#, , , , , , , ,#,#,#,#,#,#,#,#,#,#,#,#,#,#,#,#,#,#,#,#,#,#,#,#,#,#,
#,#,#,#,#,#,#,#,#,#,#,#,#,#,#,#,#,#,#,#,#,#,#,#,#,#,#,#,#,#,#,#,#,#,#,#,#,#,#,#,#,#,#,#,#,#,#,#,#,#,
#,#,#,#,#,#,#,#,#,#,#,#,#,#,#,#,#,#,#,#,#,#,#,#,#,#,#,#,#,#,#,#,#,#,#,#,#,#,#,#,#,#,#,#,#,#,#,#,#,#,
