#,#,#,#,#,#,#,#,#,#,#,#,#,#,#,#,#,#,#,#,#,#,#,#,#,#,#,#,#,#,#,#,#,#,#,#,#,#,#,#,#,#,#,#,#,#,#,#,#,#,
#,#,#,#, , , , , , ,#,#,#,#,#,#,#,#,#,#,#,#,#,#,#,#,#,#,#,#,#,#,#,#,#,#,#, , , , , ,#,#,#,#,#,#,#,#,
#,#,#, , , , , , , , ,#,#,#,#,#,#,#,#,#,#,#,#,#,#,#,#,#,#,#,#,#,#,#,#,#, , , , , , , ,#,#,#,#,#,#,#,
#,#, , , ,#,#,#,#, , ,#,#,#,#, , ,#,#, , , ,#,#,#,#,#,#,#,#,#,#,#,#,#, , , ,#,#, , ,#,#,#,#,#,#,#,#,
#,#, , ,#,#,#,#,#,#, , ,#,#, , , , , , , , , ,#,#,#,#,#,#,#,#,#,#,#, , , ,#,#,#,#,#,#,#,#,#,#,#,#,#,
#,#, , ,#,#,#,#,#,#, , , , , , , , , , , , , , ,#,#,#,#,#,#,#,#,#, , , ,#,#,#,#,#,#,#,#,#,#,#,#,#,#,
#,#, , ,#,#,#,#,#,#, , , , , , , ,#,#,#,#,#, , ,#,#,#,#,#,#,#,#,#, , , ,#,#,#,#,#,#,#,#,#,#,#,#,#,#,
#,#, , ,#,#,#,#,#, , , , , , , ,#,#,#,#,#,#,#, , ,#,#,#,#,#,#,#, , , , , ,#,#,#,#,#,#,#,#,#,#,#,#,#,
#,#, , ,#,#,#,#, , , , , , , , ,#,#,#,#,#,#,#, , ,#,#,#,#,#,#,#, , , , , , ,#,#,#,#,#,#,#,#,#,#,#,#,
#,#, , , ,#,#, , , , , , , , , , ,#,#,#,#,#,#, , ,#,#,#,#,#,#,#,#, , , , , , ,#,#,#,#,#,#,#,#,#,#,#,
#,#, , , , , , , ,#,#,#,#,#, , , , ,#,#,#,#, , , ,#,#,#,#,#,#,#,#,#,#,#,#, , , , ,#,#,#,#,#,#,#,#,#,
#,#,#, , , , , ,#,#,#,#,#,#,#, , , , , , , , , ,#,#,#,#,#,#,#,#,#,#,#,#,#,#, , , , ,#,#,#,#,#,#,#,#,
#,#,#, , , , ,#,#,#,#,#,#,#,#,#,#, , , , , ,#,#,#,#,#,#,#,#,#,#,#,#,#,#,#,#,#, , , , ,#,#,#,#,#,#,#,
#,#,#, , , , ,#,#,#,#,#,#,#,#,#,#,#, , , ,#,#,#,#,#,#,#,#,#,#,#,#,#,#,#,#,#,#, , , , , ,#,#,#,#,#,#,
#,#, , , , , , ,#,#,#,#,#,#,#,#,#,#,#,#,#,#,#,#,#,#,#,#,#,#,#,#,#,#,#,#,#,#,#, , , , , , ,#,#,#,#,#,
#,#, , ,#,#, , , ,#,#,#,#,#,#,#,#,#,#,#,#,#,#,#,#,#,#,#,#,#,#,#,#,#,#,#,#,#,#, , , ,#,#, , ,#,#,#,#,
#, , ,#,#,#,#, , ,#,#,#,#,#,#,#,#,#,#,#,#,#,#,#,#,#,#,#,#,#,#,#,#,#,#,#,#,#,#, , ,#,#,#,#, , ,#,#,#,
#, , ,#,#,#,#, , , ,#,#,#,#,#,#,#,#,#,#, , ,#,#,#,#,#,#,#,#,#,#,#,#,#,#,#,#,#, , ,#,#,#,#, , , ,#,#,
#, , ,#,#,#,#, , , , ,#,#,#,#,#,#,#,#, , , , , ,#,#,#,#,#, , ,#,#,#,#,#,#,#, , , ,#,#,#,#,#, , ,#,#,
#, , ,#,#,#,#,#, , , , , ,#,#,#,#,#,#, , , , , , , ,#,#, , , , , ,#,#,#,#, , , , ,#,#,#,#,#, , ,#,#,
#, , ,#,#,#,#,#,#, , , , , , , ,#,#,#,#, , , , , , , , , , , , , , , , , , , , , ,#,#,#,#,#, , ,#,#,
#, , , ,#,#,#,#,#,#,#,#, , , , , ,#,#,#, , , , , , , , ,#,#,#, , , , , , , , , , , ,#,#,#, , , ,#,#,
#,#, , , , , , ,#,#,#,#,#,#,#,#, , ,#, , , , , ,#,#,#,#,#,#,#,#,#, , , , , , , , , , , , , , ,#,#,#,
#,#,#, , , , , , ,#,#,#,#,#,#,#,#, , , , , , , ,#,#,#,#,#,#,#,#,#,#, , , , ,#,#,#,#,#, , , ,#,#,#,#,
#,#,#,#,#,#, , , , ,#,#,#,#,#,#,#,#, , , , , , , , ,#,#,#,#,#,#,#,#, , ,#,#,#,#,#,#,#,#,#,#,#,#,#,#,
#,#,#,#,#,#,#, , , , ,#,#,#,#,#,#,#, , , , , , , , , ,#,#,#,#,#,#, , ,#,#,#,#,#,#,#,#,#,#,#,#,#,#,#,
#,#,#,#,#,#,#,#, , , ,#,#,#,#,#,#,#, , , , , , , , , , ,#,#,#,#, , ,#,#,#,#,#,#,#,#,#,#,#,#,#,#,#,#,
#,#,#,#,#,#,#,#, , , ,#,#,#,#,#,#, , , , , ,#,#,#,#, , , , , , , , ,#,#,#,#,#,#,#,#,#,#,#,#,#,#,#,#,
#,#,#,#,#,#,#,#,#, , ,#,#,#,#,#, , , , , ,#,#,#,#,#,#,#, , , , , ,#,#,#,#,#,#,#,#,#,#,#,#,#,#,#,#,#,
#,#,#,#,#,#,#,#,#, , , ,#,#, , , , , , , ,#,#,#,#,#,#,#,#, , ,#,#,#,#,#,#,#,#,#,#,#,#,#,#,#,#,#,#,#,
#,#,#,#,#,#,#,#,#, , , , , , , ,#,#, , , ,#,#,#,#,#,#,#,#,#,#,#,#,#,#,#,#,#,#,#,#,#,#,#,#,#,#,#,#,#,
#,#,#,#,#,#,#,#,#, , , , , , ,#,#,#,#,#,#,#,#,#,#,#,#,#,#,#,#,#,#,#,#,#,#,#,#,#,#,#,#,#,#,#,#,#,#,#,
#,#,#,#,#,#,#,#,#, , , , , , ,#,#,#,#,#,#,#,#,#,#,#,#,#,#,#,#,#,#,#,#,#,#,#,#,#,#,#,#,#,#,#,#,#,#,#,
#,#,#,#,#,#,#,#, , , , , , , ,#,#,#,#,#,#,#,#,#,#,#,#,#,#,#,#,#,#,#,#,#,#,#,#,#,#,#,#,#,#,#,#,#,#,#,
#,#,#,#,#, , , , , , , , , ,#,#,#,#,#,#,#,#,#,#,#,#,#,#,#,#,#,#,#,#,#,#,#,#,#,#,#,#,#,#,#,#,#,#,#,#,
#,#,#,#, , , , , , , , , ,#,#,#,#,#,#,#,#, , , , , , , ,#,#,#,#,#,#,#,#,#,#,#, , , , ,#,#,#,#,#,#,#,
#,#,#,#, , , ,#,#,#, , , ,#,#,#,#,#,#,#, , , , , , , , , ,#,#,#,#,#,#,#,#,#, , , , , , , , ,#,#,#,#,
#,#,#,#, , ,#,#,#,#,#, , , ,#,#,#,#,#,#, , ,#,#,#, , , , , ,#,#, , ,#,#, , , ,#,#,#, , , , , ,#,#,#,
#,#,#, , ,#,#,#,#,#,#, , , , , , ,#,#, , ,#,#,#,#,#,#, , , , , , , , , , , ,#,#,#,#,#, , , , ,#,#,#,
#,#,#, , ,#,#,#,#,#,#,#, , , , , , , , ,#,#,#,#,#,#,#,#, , , , , , , , , , ,#,#,#,#,#,#, , , ,#,#,#,
#,#, , ,#,#,#,#,#,#,#,#, , , , , , , , ,#,#,#,#,#,#,#,#, , , , , , , , , , ,#,#,#,#,#,#, , , ,#,#,#,
#,#, , ,#,#,#,#,#,#,#, , , , , , , , , , ,#,#,#,#,#,#, , , , , , , , , , , ,#,#,#,#,#,#, , ,#,#,#,#,
#,#, , , ,#,#,#,#,#, , , , , , , , , , , , ,#,#,#,#, , , , , , , , , , , , , ,#,#,#,#, , , ,#,#,#,#,
#,#, , , , , , , , , ,#,#,#, , , ,#,#, , , , , , , , , , ,#,#,#,#,#,#,#, , , , , , , , , , ,#,#,#,#,
#,#, , , , , , , , ,#,#,#,#,#,#,#,#,#,#, , , , , , , ,#,#,#,#,#,#,#,#,#,#,#,#, , , , , , , ,#,#,#,#,
#,#,#, , , , ,#,#,#,#,#,#,#,#,#,#,#,#,#,#, , , , , ,#,#,#,#,#,#,#,#,#,#,#,#,#,#,#,#, , , , ,#,#,#,#,
#,#,#,#, , ,#,#,#,#,#,#,#,#,#,#,#,#,#,#,#,#, , , ,#,#,#,#,#,#,#,#,#,#,#,#,#,#,#,#,#,#, , ,#,#,#,#,#,
#,#,#,#,#,#,#,#,#,#,#,#,#,#,#,#,#,#,#,#,#,#,#,#,#,#,#,#,#,#,#,#,#,#,#,#,#,#,#,#,#,#,#,#,#,#,#,#,#,#,
#,#,#,#,#,#,#,#,#,#,#,#,#,#,#,#,#,#,#,#,#,#,#,#,#,#,#,#,#,#,#,#,#,#,#,#,#,#,#,#,#,#,#,#,#,#,#,#,#,#,
#,#,#,#,#,#,#,#,#,#,#,#,#,#,#,#,#,#,#,#,#,#,#,#,#,#,#,#,#,#,#,#,#,#,#,#,#,#,#,#,#,#,#,#,#,#,#,#,#,#,
