#,#,#,#,#,#,#,#,#,#,#,#,#,#,#,#,#,#,#,#,#,#,#,#,#,#,#,#,#,#,#,#,#,#,#,#,#,#,#,#,#,#,#,#,#,#,#,#,#,#,
#,#,#,#,#,#,#,#,#,#,#,#,#,#,#,#,#, , , , , , , , , ,#,#,#,#,#,#,#,#,#,#,#,#,#,#,#,#,#,#,#,#,#,#,#,#,
#,#,#,#,#,#,#,#,#,#,#,#,#,#,#,#, , , , , , , , , , , ,#,#,#,#,#,#,#,#,#,#,#,#, , , , , , , ,#,#,#,#,
#,#,#, , , , , , ,#,#,#,#,#,#, , , , ,#,#,#,#,#,#, , , ,#,#,#,#,#,#,#,#,#,#, , , , , , , , , ,#,#,#,
#,#, , , , , , , , ,#,#,#,#,#, , , ,#,#,#,#,#,#,#,#, , ,#,#,#,#,#, ,#,#,#, , , ,#,#,#, , , , ,#,#,#,
#,#, , , ,#,#, , , , , ,#,#, , , ,#,#,#,#,#,#,#,#,#, , ,#,#,#,#, , , , , , , ,#,#,#,#,#, , ,#,#,#,#,
#,#, , ,#,#,#,#, , , , , , , , , ,#,#,#,#,#,#,#,#, , ,#,#,#,#,#,#, , , , , ,#,#,#,#,#,#, , ,#,#,#,#,
#,#, , ,#,#,#,#,#, , , , , , , , , ,#,#,#,#,#,#,#, , ,#,#,#,#,#,#,#, , , , ,#,#,#,#,#,#, , , ,#,#,#,
#,#, , ,#,#,#,#,#,#, , , , , , , , , , , ,#,#,#, , ,#,#,#,#,#,#,#,#,#, , , ,#,#,#,#,#, , , , ,#,#,#,
#, , , ,#,#,#,#,#,#, , , , ,#,#, , , , , , , , , , ,#,#,#,#,#,#,#,#,#, , , , ,#,#,#, , , , ,#,#,#,#,
#, , , , ,#,#,#,#, , , , ,#,#,#,#, , , , , , , , , ,#,#,#,#,#,#,#,#,#, , , , , , , , , , ,#,#,#,#,#,
#,#, , , , , , , , , , ,#,#,#,#,#,#,#, , , , , , , ,#,#,#,#,#,#,#,#,#,#, , , , , , , , ,#,#,#,#,#,#,
#,#,#, , , , , , , , ,#,#,#,#,#,#,#,#,#, , , , , , ,#,#,#,#,#,#,#,#,#,#,#, , , , , , ,#,#,#,#,#,#,#,
#,#,#,#,#,#,#, , , ,#,#,#,#,#,#,#,#,#,#, , , , , , ,#,#,#,#,#,#,#,#,#,#,#, , , , , , ,#,#,#,#,#,#,#,
#,#,#,#,#,#,#,#,#,#,#,#,#,#,#,#,#,#,#, , , ,#,#, , ,#,#,#,#,#,#,#,#,#,#,#,#, , , , , ,#,#,#,#,#,#,#,
#,#,#,#,#,#,#,#,#,#,#,#,#,#,#,#,#,#, , , ,#,#,#,#, ,#,#,#,#,#,#,#,#,#,#,#,#,#, , , , , ,#,#,#,#,#,#,
#,#,#,#,#,#,#,#,#,#,#,#,#,#,#,#,#, , , ,#,#,#,#,#, , ,#,#,#,#,#,#,#,#,#,#,#,#, , , , , ,#,#,#,#,#,#,
#,#,#,#,#,#,#,#,#,#,#,#,#,#,#,#, , , ,#,#,#,#,#,#, , ,#,#,#,#,#,#,#,#,#,#,#,#, , , , , ,#,#,#,#,#,#,
#,#,#,#,#,#,#,#,#,#,#,#,#,#,#,#, , ,#,#,#,#,#,#, , , ,#,#,#,#,#,#,#,#,#,#,#, , , , , , , ,#,#,#,#,#,
#,#,#,#,#,#,#,#,#,#,#,#,#,#,#,#, , ,#,#,#,#,#,#, , , ,#,#,#,#,#,#,#,#,#,#, , , ,#,#,#, , ,#,#,#,#,#,
#,#,#,#,#,#,#,#,#,#,#,#,#,#,#,#, , , ,#,#,#,#,#, , ,#,#,#,#,#,#,#,#,#,#, , , ,#,#,#,#,#, , ,#,#,#,#,
#,#,#,#,#,#,#,#,#,#,#,#,#,#,#,#, , , , ,#,#,#,#, , ,#,#,#,#,#,#,#,#,#,#, , ,#,#,#,#,#,#, , , ,#,#,#,
#,#, , , , , , ,#,#,#,#,#,#,#,#,#, , , , ,#,#, , , , ,#,#,#,#,#,#,#,#,#, ,#,#,#,#,#,#,#, , , ,#,#,#,
#,#, , , , , , , , , ,#,#,#,#,#,#,#,#,#, , , , , , , , ,#,#,#,#,#,#,#, , ,#,#,#,#,#,#, , , , ,#,#,#,
#,#, , ,#,#,#, , , , , ,#,#,#,#,#,#,#,#,#, , , , , , , , , , , , , , , , , ,#,#,#,#, , , , ,#,#,#,#,
#,#,#,#,#,#,#,#,#, , , ,#,#,#,#,#,#,#,#,#, , , , , , , , , , , , , , , , , , , , , , , , , ,#,#,#,#,
#,#,#,#,#,#,#,#,#,#, , ,#,#,#,#,#,#,#,#, , , , , , , ,#,#,#, , , , , , , , , , , , ,#,#, , ,#,#,#,#,
#,#,#,#,#,#,#,#,#,#, , , ,#,#,#,#,#,#,#, , , , , , ,#,#,#,#,#, , , , , , ,#,#, , ,#,#,#,#,#,#,#,#,#,
#,#,#,#,#,#,#,#,#, , , , , ,#,#,#,#,#,#, , , , , ,#,#,#,#,#,#, , , , , ,#,#,#,#,#,#,#,#,#,#,#,#,#,#,
#,#,#,#,#,#,#,#, , , , , , , ,#,#,#,#,#, , , , ,#,#,#,#,#,#,#, , , , ,#,#,#,#,#,#,#,#,#,#,#,#,#,#,#,
#,#,#,#,#,#, , , , , , , , , ,#,#,#,#,#,#, , , ,#,#,#,#,#,#, , , , ,#,#,#,#,#,#,#,#,#,#,#,#,#,#,#,#,
#,#,#,#,#, , , , , , , , , ,#,#,#,#,#,#,#,#, , ,#,#,#,#,#, , , ,#,#,#,#,#,#,#,#,#,#,#,#,#,#,#,#,#,#,
#,#,#,#,#, , , , , , , , ,#,#,#,#,#,#,#,#,#, , , ,#,#,#, , , ,#,#,#,#,#,#,#,#,#,#,#,#,#,#,#,#,#,#,#,
#,#,#,#,#, , , , , , ,#,#,#,#,#,#,#,#,#,#,#,#, , , , , , , , ,#,#,#,#,#,#,#,#,#,#,#,#,#,#,#,#,#,#,#,
#,#,#,#,#, , , , , ,#,#,#,#,#,#,#,#,#,#,#,#,#,#, , , , , , , ,#,#,#,#,#,#, , ,#,#,#,#,#,#,#,#,#,#,#,
#,#,#,#, , , , , ,#,#,#,#,#,#,#,#,#,#,#,#,#,#,#, , , , , , ,#,#,#,#,#,#, , , , ,#,#,#,#,#,#,#,#,#,#,
#,#,#, , , , , ,#,#,#,#,#,#,#,#,#,#,#,#,#,#,#, , , , , , ,#,#,#,#,#,#,#, , , , , , , , , , ,#,#,#,#,
#,#,#, , , , ,#,#,#,#,#,#,#,#,#,#,#,#,#,#,#, , , , , , , ,#,#,#,#,#,#,#, , , , , , , , , , , ,#,#,#,
#,#,#,#, , , ,#,#,#,#,#,#,#,#,#,#,#,#,#,#, , , ,#,#, , , ,#,#,#,#,#,#, , , , ,#,#,#,#, , , , ,#,#,#,
#,#,#,#, , ,#,#,#,#,#,#, , , ,#,#,#,#,#, , , ,#,#,#,#, , ,#,#,#,#,#, , , , ,#,#,#,#,#,#, , , , ,#,#,
#,#,#,#, , ,#,#,#,#,#,#, , , , , , , , , , ,#,#,#,#,#, , , ,#,#, , , , , , ,#,#,#,#,#,#, , , , ,#,#,
#,#,#,#, , ,#,#,#,#,#,#, , , , , , , , , ,#,#,#,#,#,#,#, , , , , , ,#, , , , ,#,#,#,#,#, , , ,#,#,#,
#,#,#,#, , ,#,#,#,#,#, , , , , , , , , ,#,#,#,#,#,#,#,#, , , , , , ,#,#, , , , ,#,#,#, , ,#,#,#,#,#,
#,#,#,#, , ,#,#,#,#, , , , , , , , , , ,#,#,#,#,#,#,#, , , , , , , ,#,#, , , , , , , , ,#,#,#,#,#,#,
#,#,#, , , , ,#,#, , , , , , , , , , , , ,#,#,#,#,#, , , ,#,#, , , ,#,#, , , , , , , ,#,#,#,#,#,#,#,
#,#,#, , , , , , , , ,#,#,#,#, , , , , , , , , , , , , ,#,#,#,#, ,#,#,#,#, , , , , ,#,#,#,#,#,#,#,#,
#,#,#,#, , , , , , ,#,#,#,#,#,#, , ,#,#,#, , , , , , , ,#,#,#,#,#,#,#,#,#,#, , ,#,#,#,#,#,#,#,#,#,#,
#,#,#,#,#,#,#,#,#,#,#,#,#,#,#,#,#,#,#,#,#,#,#,#,#, , ,#,#,#,#,#,#,#,#,#,#,#,#,#,#,#,#,#,#,#,#,#,#,#,
#,#,#,#,#,#,#,#,#,#,#,#,#,#,#,#,#,#,#,#,#,#,#,#,#,#,#,#,#,#,#,#,#,#,#,#,#,#,#,#,#,#,#,#,#,#,#,#,#,#,
#,#,#,#,#,#,#,#,#,#,#,#,#,#,#,#,#,#,#,#,#,#,#,#,#,#,#,#,#,#,#,#,#,#,#,#,#,#,#,#,#,#,#,#,#,#,#,#,#,#,
