#,#,#,#,#,#,#,#,#,#,#,#,#,#,#,#,#,#,#,#,#,#,#,#,#,#,#,#,#,#,#,#,#,#,#,#,#,#,#,#,#,#,#,#,#,#,#,#,#,#,
#,#,#,#,#,#,#,#,#,#,#,#,#,#,#,#,#,#,#,#,#,#, , , , , , ,#,#,#,#,#,#, , , , , , , , ,#,#,#,#,#,#,#,#,
#,#,#,#,#, , , , ,#,#,#,#,#,#,#,#,#,#,#,#, , , , , , , , , , , , , , , , , , , , , , ,#,#,#,#,#,#,#,
#,#,#,#, , , , , , ,#,#,#,#,#,#,#,#,#,#, , ,#,#,#,#,#,#, , , , , , , , , ,#,#,#, , , ,#,#,#,#,#,#,#,
#,#,#,#, , , , , , ,#,#,#,#,#,#,#,#,#, , ,#,#,#,#,#,#,#,#, , , , , , , ,#,#,#,#,#, , ,#,#,#,#,#,#,#,
#,#,#, , , , , , ,#,#,#,#,#,#,#,#,#,#, , ,#,#,#,#,#,#,#,#, , , , , , , ,#,#,#,#,#, , , ,#,#,#,#,#,#,
#,#, , , , , , , ,#,#,#,#,#,#,#,#,#, , , ,#,#,#,#,#,#,#, , , , , , , , , ,#,#,#,#,#, , , , ,#,#,#,#,
#, , , , , , , , ,#,#,#,#,#,#,#,#,#, , , ,#,#,#,#,#,#, , , ,#,#,#,#,#, , , ,#,#,#,#,#, , , , ,#,#,#,
#, , , ,#,#, , , , ,#,#,#,#,#,#,#,#, , , , ,#,#,#,#,#, , ,#,#,#,#,#,#,#, , , , ,#,#,#,#, , , ,#,#,#,
#, , ,#,#,#,#, , , , ,#,#,#,#,#,#,#,#, , , , ,#,#,#, , , ,#,#,#,#,#,#,#,#, , , , ,#,#,#,#,#, , ,#,#,
#, , ,#,#,#,#,#,#, ,#,#,#,#,#,#,#,#,#,#, , , , , , , , , ,#,#,#,#,#,#,#,#,#, , , , ,#,#,#,#,#, , ,#,
#, , ,#,#,#,#,#,#,#,#,#,#,#,#,#,#,#,#,#, , , , , , , , , , ,#,#,#,#,#,#,#,#,#, , , ,#,#,#,#,#, , ,#,
#, , , ,#,#,#,#,#,#,#,#,#,#,#,#,#,#,#, , , , , , , , , , , , ,#,#,#,#,#,#,#,#,#, , ,#,#,#,#,#, , ,#,
#, , , , , , , , , ,#,#,#,#,#,#,#,#, , , , , , , , , , , , , , ,#,#,#,#,#,#,#,#, , , ,#,#,#, , ,#,#,
#, , , , , , , , , , , ,#,#,#,#,#, , , ,#,#, , , , , ,#,#, , , , ,#,#,#,#,#,#,#,#, , , , , , ,#,#,#,
#, , , , , ,#,#,#,#, , , ,#,#,#, , , ,#,#,#,#, , , ,#,#,#,#, , , ,#,#,#,#,#,#,#,#,#, , , , , ,#,#,#,
#, , , , ,#,#,#,#,#,#, , , , , , , ,#,#,#,#,#, , , ,#,#,#,#,#, , ,#,#,#,#,#,#,#,#,#, , , , ,#,#,#,#,
#,#, , ,#,#,#,#,#,#,#,#, , , , , ,#,#,#,#,#,#,#, ,#,#,#,#,#,#, , ,#,#,#,#,#,#,#,#, , , , , ,#,#,#,#,
#,#,#,#,#,#,#,#,#,#,#,#,#,#,#,#,#,#,#,#,#,#,#,#,#,#,#,#,#,#,#, ,#,#,#,#,#,#,#,#, , , , , , ,#,#,#,#,
#,#,#,#,#,#,#,#,#,#,#,#,#,#,#,#,#,#,#,#,#,#,#,#,#,#,#,#,#,#, , ,#,#,#,#,#,#, , , , ,#,#, , ,#,#,#,#,
#,#,#,#,#,#,#,#,#,#,#,#,#,#,#,#,#,#,#,#,#,#,#,#,#,#,#,#,#, , , , ,#,#,#,#, , , , ,#,#,#,#, , ,#,#,#,
#,#,#,#,#,#,#,#,#,#,#,#,#,#,#,#,#,#,#,#,#,#,#,#,#,#,#,#, , , , , ,#,#,#,#, , , ,#,#,#,#,#, , ,#,#,#,
#,#,#,#,#,#,#,#,#,#,#,#,#,#,#,#,#,#,#,#,#,#,#,#,#,#,#,#, , , , ,#,#,#,#,#, , , ,#,#,#,#, , , ,#,#,#,
#,#,#,#,#,#,#,#,#,#,#,#,#,#,#,#,#,#,#,#,#,#,#,#,#,#,#,#,#, , ,#,#,#,#,#,#, , , ,#,#,#,#, , , ,#,#,#,
#,#,#,#,#,#,#,#,#,#,#,#,#,#,#,#,#,#,#,#,#,#,#,#,#,#,#,#,#,#,#,#,#,#,#,#,#, , ,#,#,#,#,#, , , ,#,#,#,
#,#,#, , ,#,#,#,#,#,#,#,#,#,#,#,#,#,#,#,#,#,#,#,#,#,#,#,#,#,#,#,#,#,#,#,#, , ,#,#,#,#,#, , , ,#,#,#,
#,#, , , , , ,#,#,#,#,#,#,#,#,#,#,#,#,#,#,#,#,#,#,#,#,#,#,#,#,#,#,#,#,#,#, , ,#,#,#,#,#, , , ,#,#,#,
#,#, , , , , , ,#,#,#,#,#,#,#,#,#,#,#,#,#,#,#,#,#,#,#,#,#,#,#,#,#,#,#,#,#, , ,#,#,#,#,#, , ,#,#,#,#,
#,#,#, , , , , ,#,#,#,#,#,#,#,#,#,#,#,#,#,#,#,#, , ,#,#,#,#,#,#,#,#,#,#, , , ,#,#,#,#,#, , ,#,#,#,#,
#,#,#,#, , , , ,#,#,#,#,#,#,#,#,#,#,#,#,#,#,#, , , , ,#,#,#,#,#,#,#,#,#, , , ,#,#,#,#, , , , ,#,#,#,
#,#,#,#,#,#, , ,#,#,#,#,#,#,#,#,#,#,#,#,#,#,#, , , , ,#,#,#,#,#,#,#,#,#, , , , ,#,#, , , , , ,#,#,#,
#,#,#,#,#,#, , , ,#,#,#,#,#,#,#,#,#,#,#,#,#,#,#, , , ,#,#,#,#,#,#,#,#,#, , , , , , , , , , ,#,#,#,#,
#,#,#,#,#,#,#, , , ,#,#,#,#,#,#,#,#,#,#,#,#,#,#,#, , ,#,#,#,#,#,#,#,#,#, , , , , , , , ,#,#,#,#,#,#,
#,#,#,#,#,#, , , , , , , , , , , , , ,#,#,#,#,#,#,#, , ,#,#,#,#,#,#,#,#,#, , , , , , ,#,#,#,#,#,#,#,
#,#,#,#,#, , , , , , , , , , , , , , , ,#,#,#,#,#,#, , , ,#,#,#,#,#,#,#,#, , , , , , ,#,#,#, , ,#,#,
#,#,#, , , ,#,#,#,#, , , , , , , , , , ,#,#,#,#,#,#, , , , , ,#,#,#,#,#,#, , , , , , , , , , , , ,#,
#,#, , , ,#,#,#,#,#,#, , , , , , , , , , ,#,#,#,#, , , , , , , , ,#,#,#, , , , , , , , , , , , , ,#,
#,#, , , ,#,#,#,#,#,#,#, , , , , , , , , , , , , , , , , , , , , , , , , , , , , , , ,#,#,#, , ,#,#,
#,#, , ,#,#,#,#,#,#,#,#,#, , ,#,#,#,#,#, , , , , , , , , , , , , , , , , , ,#,#, , , ,#,#,#,#,#,#,#,
#,#, , ,#,#,#,#,#,#,#,#,#,#,#,#,#,#,#,#,#, , , , ,#,#,#, , , , , , , ,#,#,#,#,#,#, , , ,#,#,#,#,#,#,
#,#, , , ,#,#,#,#,#,#,#,#,#,#,#,#,#,#,#,#,#,#,#,#,#,#,#,#, , , , , ,#,#,#,#,#,#,#, , , ,#,#,#,#,#,#,
#,#,#, , , , , ,#,#,#,#,#,#,#,#,#,#,#,#,#,#,#,#,#,#,#,#,#,#,#, , , ,#,#,#,#,#,#,#, , , ,#,#,#,#,#,#,
#,#,#,#, , , , ,#,#,#,#,#,#,#,#,#,#,#,#,#,#,#,#,#,#,#,#,#,#,#,#, , , ,#,#,#,#,#,#,#, , ,#,#,#,#,#,#,
#,#,#,#,#,#,#,#,#,#,#,#,#,#,#,#,#,#,#,#,#,#,#,#,#,#,#,#,#,#,#,#,#, , , ,#,#,#,#,#,#, , ,#,#,#,#,#,#,
#,#,#,#,#,#,#,#,#,#,#,#,#,#,#,#,#,#,#,#,#,#,#,#,#,#,#,#,#,#,#,#,#,#, , , ,#,#,#,#, , , ,#,#,#,#,#,#,
#,#,#,#,#,#,#,#,#,#,#,#,#,#,#,#,#,#,#,#,#,#,#,#,#,#,#,#,#,#,#,#,#,#,#, , , , , , , , ,#,#,#,#,#,#,#,
#,#,#,#,#,#,#,#,#,#,#,#,#,#,#,#,#,#,#,#,#,#,#,#,#,#,#,#,#,#,#,#,#,#,#,#, , , , , , ,#,#,#,#,#,#,#,#,
#,#,#,#,#,#,#,#,#,#,#,#,#,#,#,#,#,#,#,#,#,#,#,#,#,#,#,#,#,#,#,#,#,#,#,#,#,#, , , ,#,#,#,#,#,#,#,#,#,
#,#,#,#,#,#,#,#,#,#,#,#,#,#,#,#,#,#,#,#,#,#,#,#,#,#,#,#,#,#,#,#,#,#,#,#,#,#,#,#,#,#,#,#,#,#,#,#,#,#,
#,#,#,#,#,#,#,#,#,#,#,#,#,#,#,#,#,#,#,#,#,#,#,#,#,#,#,#,#,#,#,#,#,#,#,#,#,#,#,#,#,#,#,#,#,#,#,#,#,#,
