#,#,#,#,#,#,#,#,#,#,#,#,#,#,#,#,#,#,#,#,#,#,#,#,#,#,#,#,#,#,#,#,#,#,#,#,#,#,#,#,#,#,#,#,#,#,#,#,#,#,
#,#,#,#,#,#,#,#,#,#,#,#,#,#,#,#,#,#,#,#,#,#,#, , , ,#,#,#,#,#,#,#,#,#,#,#,#,#,#,#,#,#,#,#,#,#,#,#,#,
#,#,#,#, , , , , , ,#,#,#,#,#,#,#,#,#,#, , , , , , , , ,#,#,#,#,#,#,#,#,#,#,#,#,#, , , , ,#,#,#,#,#,
#,#,#, , , , , , , , ,#,#,#,#,#,#,#,#, , , ,#,#,#,#, , , , , ,#,#,#,#,#,#,#,#,#, , , , , , , ,#,#,#,
#,#, , , ,#,#,#,#, ,#,#,#,#,#,#,#,#,#, , ,#,#,#,#,#,#, , , , ,#,#,#,#,#,#,#,#, , , , , , , , , ,#,#,
#,#, , ,#,#,#,#,#,#,#,#,#,#,#,#,#,#,#, , ,#,#,#,#,#,#, , , , ,#,#,#,#,#,#,#, , , ,#,#,#, , , , ,#,#,
#,#, , ,#,#,#,#,#,#,#,#,#,#,#,#,#,#,#, , ,#,#,#,#,#,#, , , ,#,#,#,#,#,#,#, , , ,#,#,#,#,#, , , ,#,#,
#,#, , , ,#,#,#,#,#,#,#,#,#,#,#,#,#, , , , ,#,#,#,#, , , ,#,#,#,#,#,#,#,#, , , ,#,#,#,#,#, , ,#,#,#,
#,#,#, , ,#,#,#,#,#,#,#,#,#,#,#,#, , , , , , , , , , , , ,#,#,#,#,#,#,#,#,#, , ,#,#,#,#,#, , ,#,#,#,
#,#,#, , ,#,#,#,#,#,#,#,#,#,#,#,#, , , , , , , , , , , ,#,#,#,#,#,#,#,#,#,#, , ,#,#,#,#,#, , ,#,#,#,
#,#,#, , , ,#,#,#,#,#,#,#,#,#,#,#, , , , , , , , , ,#,#,#,#,#,#,#,#,#,#,#,#, , , ,#,#,#, , , ,#,#,#,
#,#,#,#, , ,#,#,#,#,#,#,#,#,#,#,#,#, , , , , , , ,#,#,#,#,#,#,#,#,#,#,#,#,#, , , , , , , , ,#,#,#,#,
#,#,#,#, , ,#,#,#,#,#,#,#,#,#,#,#,#, , , , , , ,#,#,#,#,#,#,#,#,#,#,#,#,#, , , , , , , , ,#,#,#,#,#,
#,#,#,#, , ,#,#,#,#,#,#,#,#,#,#,#,#,#, , , , , ,#,#,#,#,#,#,#,#,#,#, , , , , , , , ,#,#,#,#,#,#,#,#,
#,#,#,#, , , ,#,#, , ,#,#,#,#,#,#,#,#, , , , , ,#,#,#,#,#,#,#,#,#, , , , , , , , ,#,#,#,#,#,#,#,#,#,
#,#,#,#,#, , , , , , , ,#,#,#,#,#,#,#, , , , , ,#,#,#,#,#,#,#,#, , , , , , , , ,#,#,#,#,#,#,#,#,#,#,
#,#,#,#, , , , , , , ,#,#,#,#,#,#,#, , , , , , , ,#,#,#,#,#,#, , , ,#,#, , , , ,#,#,#,#,#,#,#,#,#,#,
#,#,#, , , , , , , ,#,#,#,#,#,#,#, , , ,#,#,#, , , , ,#,#, , , , ,#,#,#,#, , ,#,#,#,#,#,#,#,#,#,#,#,
#,#,#, , , , , , ,#,#,#,#,#,#,#, , , ,#,#,#,#,#, , , , , , , ,#,#,#,#,#, , , ,#,#,#,#,#,#,#,#,#,#,#,
#,#,#, , , , , , ,#,#,#,#,#,#, , , ,#,#,#,#,#,#, , , , , , ,#,#,#,#,#,#, , , ,#,#,#,#,#,#,#,#,#,#,#,
#,#,#, , , , , , , ,#,#, , , , , ,#,#,#,#,#,#,#, , , , , ,#,#,#,#,#,#,#, , , ,#,#,#,#,#,#,#,#,#,#,#,
#,#,#, , ,#,#,#, , , , , , , , ,#,#,#,#,#,#,#, , , , , , ,#,#,#,#,#,#,#, , , , ,#,#,#,#,#,#,#,#,#,#,
#,#, , ,#,#,#,#,#, , , , , , , ,#,#,#,#,#,#, , , , , , , , ,#,#,#,#,#, , , , , , , , , , ,#,#,#,#,#,
#,#, , ,#,#,#,#,#,#, , , , , , , ,#,#,#,#, , , , , , , , , , , , , , , , , , , , , , , , , ,#,#,#,#,
#,#, , ,#,#,#,#,#,#,#, , , , , , , ,#,#, , , ,#,#,#,#,#,#,#, , , , , , , , , , , , , , , , , , ,#,#,
#,#, , ,#,#,#,#,#,#,#, , , ,#,#, , , , , , ,#,#,#,#,#,#,#,#,#, , , , , , , , , , , ,#,#,#, , , , ,#,
#,#, , ,#,#,#,#,#,#, , , ,#,#,#,#, , , , ,#,#,#,#,#,#,#,#,#,#,#,#,#,#,#,#, , , , ,#,#,#,#,#, , , ,#,
#,#,#, , ,#,#,#, , , , ,#,#,#,#,#, , , , ,#,#,#,#,#,#,#,#,#,#,#,#,#,#,#,#,#, , , ,#,#,#,#,#, , , ,#,
#,#,#,#, , , , , , ,#,#,#,#,#,#,#, , , , ,#,#,#,#,#,#,#,#,#,#,#,#,#,#,#,#,#,#, , ,#,#,#,#,#, , , ,#,
#,#,#,#, , , , , ,#,#,#,#,#,#,#,#,#, , ,#,#,#,#,#,#,#,#,#,#,#,#,#,#,#,#,#,#,#,#, , ,#,#,#, , , ,#,#,
#,#,#,#,#, , , , ,#,#,#,#,#,#,#,#,#,#,#,#,#,#,#,#,#,#,#,#,#,#,#,#,#,#,#,#,#,#,#, , , , , , , ,#,#,#,
#,#,#,#,#, , , , ,#,#,#,#,#,#,#,#,#,#,#,#,#,#,#,#,#,#,#,#,#,#,#,#,#,#,#,#,#,#,#, , , , , , ,#,#,#,#,
#,#,#,#,#, , , , ,#,#,#,#,#,#,#,#,#,#,#,#,#,#,#,#,#,#,#,#,#,#,#,#,#,#,#,#,#,#,#, , , , , ,#,#,#,#,#,
#,#,#,#,#, , , , ,#,#,#,#,#,#,#,#, , , ,#,#,#,#,#,#,#,#,#,#,#,#,#,#,#,#,#,#,#, , , , , ,#,#,#,#,#,#,
#,#,#,#,#, , , , ,#,#,#,#,#,#,#, , , , , ,#,#,#,#,#,#,#,#,#,#,#,#,#,#,#,#,#, , , , ,#,#,#,#,#,#,#,#,
#,#,#,#, , , , , ,#,#,#,#,#,#,#, , , , , , , , , , ,#,#,#,#,#,#,#,#,#,#,#,#, , , , ,#,#,#,#,#,#,#,#,
#,#,#,#, , , , , , ,#,#,#,#,#,#, , , ,#,#, , , , , , ,#,#,#,#,#,#,#,#,#,#,#, , , , ,#,#,#,#,#,#,#,#,
#,#,#, , , ,#,#, , , , ,#,#,#,#, , ,#,#,#,#,#,#, , , , ,#,#,#,#,#,#,#,#,#, , , , , , ,#,#,#,#,#,#,#,
#,#,#, , ,#,#,#,#, , , , ,#,#, , ,#,#,#,#,#,#,#,#, , , , , , , ,#,#, , , , , , , , , ,#,#,#,#,#,#,#,
#,#, , ,#,#,#,#,#,#, , , , , , , ,#,#,#,#,#,#,#,#, , , , , , , , , , , , , , , , , ,#,#,#,#,#,#,#,#,
#,#, , ,#,#,#,#,#,#,#, , , , , , ,#,#,#,#,#,#,#,#, , , , , , , , , , , , ,#,#,#, , ,#,#,#,#,#,#,#,#,
#, , ,#,#,#,#,#,#,#,#, , , , , , , ,#,#,#,#,#,#, , , , , ,#,#,#,#, , , ,#,#,#,#,#, , ,#,#,#,#,#,#,#,
#, , ,#,#,#,#,#,#,#, , , , , , , , , , ,#,#,#, , , , , ,#,#,#,#,#,#,#,#,#,#,#,#,#, , ,#,#,#,#,#,#,#,
#,#, , ,#,#,#,#,#, , , , , , ,#,#, , , , , , , , , , , ,#,#,#,#,#,#,#,#,#,#,#,#,#, , ,#,#,#,#,#,#,#,
#,#,#, , ,#,#,#, , , , , , ,#,#,#,#, , , , , , , , , ,#,#,#,#,#,#,#,#,#,#,#,#,#,#, , ,#,#,#,#,#,#,#,
#,#,#,#, , , , , , , , , ,#,#,#,#,#,#, , , , , , , , ,#,#,#,#,#,#,#,#,#,#,#,#,#, , ,#,#,#,#,#,#,#,#,
#,#,#,#,#, , , ,#,#, , ,#,#,#,#,#,#,#,#, , , , , , ,#,#,#,#,#,#,#,#,#,#, , , , , , ,#,#,#,#,#,#,#,#,
#,#,#,#,#,#,#,#,#,#,#,#,#,#,#,#,#,#,#,#,#, , , , ,#,#,#,#,#,#,#,#,#,#,#, , , , , ,#,#,#,#,#,#,#,#,#,
#,#,#,#,#,#,#,#,#,#,#,#,#,#,#,#,#,#,#,#,#,#,#,#,#,#,#,#,#,#,#,#,#,#,#,#,#,#,#,#,#,#,#,#,#,#,#,#,#,#,
#,#,#,#,#,#,#,#,#,#,#,#,#,#,#,#,#,#,#,#,#,#,#,#,#,#,#,#,#,#,#,#,#,#,#,#,#,#,#,#,#,#,#,#,#,#,#,#,#,#,
