#,#,#,#,#,#,#,#,#,#,#,#,#,#,#,#,#,#,#,#,#,#,#,#,#,#,#,#,#,#,#,#,#,#,#,#,#,#,#,#,#,#,#,#,#,#,#,#,#,#,
#,#,#,#,#,#, , , , , , , , , ,#,#,#,#,#,#,#,#,#,#,#,#,#,#,#,#,#,#,#, , , ,#,#,#,#,#,#,#,#,#,#,#,#,#,
#,#,#,#, , , , , , , , , , , , ,#,#,#,#,#,#,#,#,#,#,#,#,#,#,#,#,#, , , , , , ,#,#,#,#,#,#,#,#,#,#,#,
#,#,#, , , , , , ,#,#, , , , , ,#,#,#,#,#,#,#,#,#,#,#,#,#,#,#,#, , ,#,#,#, , , ,#,#,#,#,#,#,#,#,#,#,
#,#,#, , , , , ,#,#,#,#, , , , , ,#,#,#,#,#,#,#,#,#,#,#,#,#,#, , ,#,#,#,#,#, , , ,#,#,#,#,#,#,#,#,#,
#,#,#,#, , , , ,#,#,#,#,#, , , , , , ,#,#,#,#,#,#,#,#,#,#,#, , , ,#,#,#,#,#,#, , , ,#,#,#,#,#,#,#,#,
#,#,#,#, , , ,#,#,#,#,#,#,#,#,#, , , , , , ,#,#,#,#,#,#,#, , , , ,#,#,#,#,#,#, , , ,#,#,#,#,#,#,#,#,
#,#,#, , , ,#,#, , , ,#,#,#,#,#,#,#,#, , , , ,#,#,#,#,#, , , , , , ,#,#,#,#,#, , , , ,#,#,#,#,#,#,#,
#,#, , , ,#,#, , , , , ,#,#,#,#,#,#,#,#, , , , , , , , , , , , , , , ,#,#,#,#, , , , ,#,#,#,#,#,#,#,
#, , , ,#,#,#, , , , , , , , ,#,#,#,#,#,#, , , , , , , , , , , ,#,#, , ,#,#, , , , , ,#,#,#,#,#,#,#,
#, , ,#,#,#,#, , , , , , , , , ,#,#,#,#,#,#, , , , , , , ,#,#,#,#,#,#, , , , , , , ,#,#,#,#,#,#,#,#,
#, , ,#,#,#,#, , , , , , , , , ,#,#,#,#,#,#, , , , , , ,#,#,#,#,#,#,#, , , , , , ,#,#,#,#,#,#,#,#,#,
#, , ,#,#,#,#,#, , , , , , , , ,#,#,#,#,#,#, , , , , , ,#,#,#,#,#,#,#,#, , , , , ,#,#,#,#,#,#,#,#,#,
#, , ,#,#,#,#,#, , , , , , , , ,#,#,#,#,#, , , , , , , ,#,#,#,#,#,#,#,#, , , , , ,#,#,#,#,#,#,#,#,#,
#,#, , ,#,#,#,#, , , , , , , , ,#,#,#,#, , , , , , , , ,#,#,#,#,#,#,#,#,#, , , , , ,#,#,#,#,#,#,#,#,
#,#, , , ,#,#, , , , , , , , ,#,#,#,#, , , , , , , , , ,#,#,#,#,#,#,#,#,#, , , , , , ,#,#,#,#,#,#,#,
#,#,#, , , , , , , , , , , , ,#,#,#,#, , , , , , , , ,#,#,#,#,#,#,#,#,#, , , ,#,#, , , , , , ,#,#,#,
#,#,#, , , , , , , ,#,#,#, , ,#,#,#,#, , , , , , , ,#,#,#,#,#,#,#,#, , , , ,#,#,#,#, , , , , , ,#,#,
#,#,#, , , , , , ,#,#,#,#,#, , ,#,#,#, , , , , , ,#,#,#,#,#,#, , , , , , , ,#,#,#,#,#, , , , , ,#,#,
#,#,#, , , , , , ,#,#,#,#,#, , ,#,#,#, , , , , , ,#,#,#,#,#,#, , , , , , , ,#,#,#,#,#,#, , , ,#,#,#,
#,#, , , , , , , ,#,#,#,#,#, , , ,#, , , , , , , ,#,#,#,#,#,#,#,#,#,#, , , ,#,#,#,#,#,#, , , ,#,#,#,
#,#, , , , , , , , ,#,#,#, , , , , , , , ,#,#, , , ,#,#,#,#,#,#,#,#,#,#, , ,#,#,#,#,#, , , ,#,#,#,#,
#,#, , , , , , , , , , , , , , , , , , ,#,#,#,#, , , ,#,#,#,#,#,#,#,#,#, , ,#,#,#,#,#, , ,#,#,#,#,#,
#,#, , , ,#,#,#, , , , , , , , , , , , ,#,#,#,#,#, , , ,#,#,#,#,#,#,#,#, , , ,#,#,#, , , ,#,#,#,#,#,
#,#, , ,#,#,#,#,#, , , , , , , , , , , ,#,#,#,#,#,#, , ,#,#,#,#,#,#,#,#, , , , , , , , ,#,#,#,#,#,#,
#,#, , ,#,#,#,#,#,#, , , ,#,#,#, , , ,#,#,#,#,#,#,#, , ,#,#,#,#,#,#,#,#,#, , , , , , ,#,#,#,#,#,#,#,
#,#, , ,#,#,#,#,#,#, , ,#,#,#,#,#, , ,#,#,#,#,#,#, , , ,#,#,#,#,#,#,#,#,#,#,#,#,#,#,#,#,#,#,#,#,#,#,
#,#, , ,#,#,#,#,#, , , ,#,#,#,#,#, , ,#,#,#,#,#,#, , , ,#,#,#,#,#,#,#,#,#,#,#,#,#,#,#,#,#,#,#,#,#,#,
#,#, , , ,#,#,#, , , , ,#,#,#,#,#,#, , ,#,#,#,#, , , , ,#,#,#,#,#,#,#,#,#,#,#,#,#,#,#,#,#,#,#,#,#,#,
#,#,#, , , , , , , , , ,#,#,#,#,#,#, , , ,#,#, , , , , ,#,#,#,#,#,#,#,#,#,#,#,#,#,#,#,#,#,#,#,#,#,#,
#,#,#, , , , , , , , , , ,#,#,#,#,#,#, , , , , , , , , ,#,#,#,#,#,#,#,#,#,#,#,#,#,#,#,#,#,#,#,#,#,#,
#,#,#,#, , , , , , , , , ,#,#,#,#,#,#,#, , , , , , , ,#,#,#,#,#,#,#,#,#,#,#,#,#,#,#,#,#,#,#,#,#,#,#,
#,#,#,#, , , , , , , , ,#,#,#,#,#,#,#,#, , , , , , ,#,#,#,#,#,#,#,#,#,#,#,#, , ,#,#,#,#,#,#,#,#,#,#,
#,#,#,#, , , , , , ,#,#,#,#,#,#,#,#,#,#, , , , , ,#,#,#,#,#,#,#,#,#,#,#,#, , , , ,#,#,#,#,#,#,#,#,#,
#,#,#,#,#, , , , ,#,#,#,#,#,#,#,#,#,#,#, , , , ,#,#,#,#,#,#,#,#,#,#,#,#,#, , , , ,#,#,#,#,#,#,#,#,#,
#,#,#,#,#, , , , ,#,#,#,#,#,#,#,#,#,#, , , , , ,#,#,#,#,#,#,#,#,#,#,#,#,#, , , , , ,#,#,#,#,#,#,#,#,
#,#,#,#, , , , ,#,#,#,#,#,#,#,#,#,#, , , , , , , ,#,#,#,#,#,#,#,#,#,#,#, , , , , , , ,#,#,#,#,#,#,#,
#,#, , , , , , ,#,#,#,#,#,#,#,#, , , , , ,#,#, , , ,#,#,#,#,#,#,#,#,#, , , ,#,#,#, , , ,#,#,#,#,#,#,
#, , , ,#,#,#, , ,#,#,#,#,#,#, , , , , ,#,#,#,#, , , , , ,#,#,#,#, , , , ,#,#,#,#,#, , , ,#,#,#,#,#,
#, , ,#,#,#,#,#, , ,#,#,#,#,#, , , , ,#,#,#,#,#,#, , , , , , , , , , , ,#,#,#,#,#,#,#, , , ,#,#,#,#,
#, , ,#,#,#,#,#, , , ,#,#,#,#,#, , ,#,#,#,#,#,#,#,#, , ,#,#, , , , , , ,#,#,#,#,#,#,#, , , ,#,#,#,#,
#, , ,#,#,#,#,#, , , ,#,#,#,#,#,#, ,#,#,#,#,#,#,#,#,#,#,#,#,#, , , , , , ,#,#,#,#,#, , , ,#,#,#,#,#,
#, , , ,#,#,#,#, , ,#,#,#,#,#,#,#, , ,#,#,#,#,#,#, , ,#,#,#,#, , , , , , , , , , , , , ,#,#,#,#,#,#,
#,#, , , ,#,#, , ,#,#,#,#,#,#,#,#, , , ,#,#,#, , , , , ,#,#,#, , , , , , , , , , , , ,#,#,#,#,#,#,#,
#,#,#, , , , , , ,#,#,#,#,#,#,#,#, , , , , , , , , , , , , , , ,#,#,#,#,#, , , , ,#,#,#,#,#,#,#,#,#,
#,#,#,#,#, , , , ,#,#,#,#,#,#,#,#,#, , , , , ,#,#,#,#, , , , ,#,#,#,#,#,#,#,#,#,#,#,#,#,#,#,#,#,#,#,
#,#,#,#,#,#, , ,#,#,#,#,#,#,#,#,#,#, , , , ,#,#,#,#,#,#, , ,#,#,#,#,#,#,#,#,#,#,#,#,#,#,#,#,#,#,#,#,
#,#,#,#,#,#,#,#,#,#,#,#,#,#,#,#,#,#,#, , ,#,#,#,#,#,#,#,#,#,#,#,#,#,#,#,#,#,#,#,#,#,#,#,#,#,#,#,#,#,
#,#,#,#,#,#,#,#,#,#,#,#,#,#,#,#,#,#,#,#,#,#,#,#,#,#,#,#,#,#,#,#,#,#,#,#,#,#,#,#,#,#,#,#,#,#,#,#,#,#,
#,#,#,#,#,#,#,#,#,#,#,#,#,#,#,#,#,#,#,#,#,#,#,#,#,#,#,#,#,#,#,#,#,#,#,#,#,#,#,#,#,#,#,#,#,#,#,#,#,#,
