#,#,#,#,#,#,#,#,#,#,#,#,#,#,#,#,#,#,#,#,#,#,#,#,#,#,#,#,#,#,#,#,#,#,#,#,#,#,#,#,#,#,#,#,#,#,#,#,#,#,
#,#,#,#,#,#,#,#,#,#,#,#,#,#,#,#,#,#,#,#,#,#,#,#,#,#,#,#,#,#,#,#,#,#,#,#,#,#,#,#,#,#,#,#,#,#,#,#,#,#,
#,#,#,#,#,#,#,#,#,#,#,#,#,#,#,#,#,#,#,#,#,#,#,#,#,#,#,#,#,#,#,#,#,#,#,#,#,#,#,#,#,#,#,#,#,#,#,#,#,#,
#,#,#,#,#,#,#,#,#,#,#,#,#,#,#,#,#,#,#,#,#,#,#,#,#,#,#,#,#,#,#,#,#,#,#,#, , ,#,#,#,#,#,#,#,#,#,#,#,#,
#,#,#,#,#,#,#, , , , , , ,#,#,#,#,#,#,#,#,#,#,#,#,#,#,#,#,#,#,#,#,#,#,#, , ,#,#,#,#,#,#,#,#,#,#,#,#,
#,#,#,#,#,#, , , , , , , , ,#,#,#,#,#,#,#,#,#,#,#,#,#,#,#,#,#,#,#,#,#,#, , ,#,#,#,#,#,#,#,#,#,#,#,#,
#,#,#,#,#,#, , , ,#,#,#, , , ,#,#,#,#,#,#,#,#,#,#,#,#,#, , ,#,#,#,#,#,#, , ,#,#,#,#,#,#,#,#,#,#,#,#,
#,#,#,#,#, , , ,#,#,#,#,#, , ,#,#,#,#,#,#,#,#,#,#,#,#,#, , ,#,#,#,#,#, , ,#,#,#,#,#,#,#,#,#,#,#,#,#,
#,#,#,#, , , ,#,#,#,#,#,#, ,#,#,#,#,#,#,#,#,#,#,#,#,#,#, , , ,#,#,#, , , ,#,#,#,#,#,#,#,#,#,#,#,#,#,
#,#,#,#, , , ,#,#,#,#,#, , ,#,#,#,#,#,#,#,#,#,#,#,#,#,#, , , , , , , , , ,#,#,#,#,#,#,#,#,#,#,#,#,#,
#,#,#,#, , , ,#,#,#,#,#, , ,#,#,#,#,#,#,#,#,#,#,#,#,#,#,#, , , , , , , , ,#,#,#,#,#,#,#,#,#,#,#,#,#,
#,#,#,#,#, , , ,#,#,#, , , ,#,#,#,#,#,#,#,#,#,#,#,#,#,#,#,#, , , , , , , , ,#,#,#,#,#,#,#,#,#,#,#,#,
#,#,#,#,#, , , , , , , , , ,#,#,#,#,#,#,#,#,#,#,#,#,#,#,#,#,#,#,#,#, , , , , ,#,#,#,#,#,#,#,#,#,#,#,
#,#,#,#,#, , , , , , , , , ,#,#,#,#,#,#,#,#,#,#,#,#,#,#,#,#,#,#,#,#,#, , , , , ,#,#,#,#,#,#,#,#,#,#,
#,#,#,#, , , , , , , , , , ,#,#,#,#,#,#,#,#,#,#,#,#,#,#,#,#,#,#,#,#,#, , , , , , ,#,#,#,#,#,#,#,#,#,
#,#,#,#, , , , , , , , , , ,#,#,#,#,#,#,#,#,#,#,#,#,#,#,#,#,#,#,#,#,#,#, , , , , ,#,#,#,#,#,#,#,#,#,
#,#,#,#,#, , , , , , , , , ,#,#,#,#,#,#,#,#,#,#,#,#,#,#,#,#,#,#,#,#,#,#,#, , , ,#,#,#,#,#,#,#,#,#,#,
#,#,#,#,#,#, , , , , , , , ,#,#,#,#,#,#,#,#,#,#,#,#,#,#,#,#,#,#,#,#,#,#,#, , ,#,#,#,#,#,#,#,#,#,#,#,
#,#,#,#,#,#,#, , , , , , , ,#,#,#,#,#,#,#,#,#,#,#,#,#,#,#,#,#,#,#,#,#,#,#, , ,#,#,#,#,#,#,#,#,#,#,#,
#,#,#,#,#,#,#, , , , , , , ,#,#,#,#,#,#,#,#,#,#,#,#,#,#, , ,#,#,#,#,#,#,#, , , ,#,#,#,#,#,#, ,#,#,#,
#,#,#,#,#,#, , , , , , , ,#,#,#,#,#,#,#,#,#,#,#,#, , , , , , , ,#,#,#,#, , , , , ,#,#,#,#, , , ,#,#,
#,#,#,#,#, , , , , , , , ,#,#,#,#,#,#,#,#,#,#, , , , , , , , , , , , , , ,#,#, , , , ,#,#, , , ,#,#,
#,#,#,#,#, , , , , , , , , ,#,#,#,#,#,#,#, , , , ,#,#,#,#, , , , , , , , ,#,#,#, , , , , , , , , ,#,
#,#,#,#,#,#, , , , , , , , , , , , ,#,#, , , , ,#,#,#,#,#,#, , , , , , , ,#,#,#,#,#, , , , , , , ,#,
#,#,#,#,#,#, , , ,#,#,#, , , , , , , , , , , , ,#,#,#,#,#,#, , , , , , , ,#,#,#,#,#,#, , , , , ,#,#,
#,#,#,#,#,#, , ,#,#,#,#,#,#,#, , , , , , , , , ,#,#,#,#,#, , , , , , , , ,#,#,#,#,#,#,#, , , ,#,#,#,
#,#,#,#,#, , , ,#,#,#,#,#,#,#,#, , , , , , , , , ,#,#,#, , , , , , , , ,#,#,#,#,#,#,#,#,#,#,#,#,#,#,
#,#,#, , , , ,#,#,#,#,#,#,#,#,#, , , , , , , , , , , , , , , , , ,#,#,#,#,#,#,#,#,#,#,#,#,#,#,#,#,#,
#,#, , , , ,#,#,#,#,#,#,#,#,#, , , , , , , , , , , , , , , , , ,#,#,#,#,#,#,#,#,#,#,#,#,#,#,#,#,#,#,
#,#, , , , ,#,#,#,#,#,#, , , , , , ,#,#,#, , , , , , , , , , , ,#,#,#,#,#,#,#,#,#,#,#,#,#,#,#,#,#,#,
#,#, , , ,#,#,#,#,#,#,#, , , ,#,#,#,#,#,#,#,#,#,#,#, , , , , ,#,#,#,#,#,#,#,#,#,#,#,#,#,#,#,#,#,#,#,
#,#, , ,#,#,#,#,#,#,#,#,#,#,#,#,#,#,#,#,#,#,#,#,#,#,#,#,#,#,#,#,#,#,#,#,#,#,#,#,#,#,#,#,#,#,#,#,#,#,
#,#, , ,#,#,#,#,#,#,#,#,#,#,#,#,#,#,#,#,#,#,#,#,#,#,#,#,#,#,#,#,#,#,#,#,#,#,#,#,#,#,#,#,#,#,#,#,#,#,
#, , ,#,#,#,#,#,#,#,#,#,#,#,#,#,#,#,#,#,#,#,#,#,#,#,#,#,#,#,#,#,#,#,#,#,#,#,#,#,#,#, , ,#,#,#,#,#,#,
#, , ,#,#,#,#,#,#,#,#,#,#,#,#,#,#,#,#,#,#,#,#,#,#,#,#,#,#,#,#, , ,#,#,#,#,#,#,#,#, , , , ,#,#,#,#,#,
#, , ,#,#,#,#,#,#,#,#,#,#,#,#,#,#, , , ,#,#,#,#,#,#,#,#,#,#, , , , ,#,#,#,#,#,#, , , , , , ,#,#,#,#,
#, , ,#,#,#, , , ,#,#,#,#,#,#,#, , , , , , ,#,#,#,#,#,#,#, , , , , , ,#,#,#,#, , , , , , , , ,#,#,#,
#, , ,#,#,#, , , ,#,#,#,#,#,#,#, , , , , , , ,#,#,#,#,#, , , , , , , , ,#,#, , , ,#,#,#, , , ,#,#,#,
#, , ,#,#,#, , , , ,#,#,#,#,#,#, , ,#,#, , , , ,#,#, , , ,#,#,#,#, , , , , , , ,#,#,#,#,#, , ,#,#,#,
#, , ,#,#,#, , , , , ,#,#,#,#, , ,#,#,#,#,#, , , , , , ,#,#,#,#,#,#, , , , , ,#,#,#,#,#,#, , ,#,#,#,
#, , , ,#,#,#, , , , , , , , , , ,#,#,#,#,#,#, , , , , ,#,#,#,#,#,#,#,#,#,#,#,#,#,#,#,#,#, , , ,#,#,
#,#, , , ,#,#,#,#,#,#, , , , , , ,#,#,#,#,#,#,#, , , , ,#,#,#,#,#,#,#,#,#,#,#,#,#,#,#,#, , , , ,#,#,
#,#,#, , ,#,#,#,#,#,#,#, , , , , , ,#,#,#,#,#,#, , , , , ,#,#,#,#,#,#,#,#,#,#,#,#,#, , , , , ,#,#,#,
#,#,#,#, , ,#,#,#,#,#,#, , , , , , , ,#,#,#,#,#, , , , , , ,#,#,#,#, , , , , ,#,#, , , , , ,#,#,#,#,
#,#,#,#, , ,#,#,#,#,#,#, , , , , , , ,#,#,#,#, , , , , , , , ,#,#, , , , , , , , , , , , ,#,#,#,#,#,
#,#,#,#, , ,#,#,#,#,#, , , , , , , , , ,#,#, , , , ,#,#, , , , , , , , , , , , , , , , , ,#,#,#,#,#,
#,#,#,#, , , ,#,#,#, , , , , , , , , , , , , , , ,#,#,#,#, , , , , , , , , , , , , , , ,#,#,#,#,#,#,
#,#,#,#,#, , , , , , , , ,#,#,#, , , , , , , ,#,#,#,#,#,#,#, , ,#,#,#,#, , , , ,#,#,#,#,#,#,#,#,#,#,
#,#,#,#,#,#,#, , ,#,#,#,#,#,#,#,#,#,#,#,#,#,#,#,#,#,#,#,#,#,#,#,#,#,#,#,#,#,#,#,#,#,#,#,#,#,#,#,#,#,
#,#,#,#,#,#,#,#,#,#,#,#,#,#,#,#,#,#,#,#,#,#,#,#,#,#,#,#,#,#,#,#,#,#,#,#,#,#,#,#,#,#,#,#,#,#,#,#,#,#,
