#,#,#,#,#,#,#,#,#,#,#,#,#,#,#,#,#,#,#,#,#,#,#,#,#,#,#,#,#,#,#,#,#,#,#,#,#,#,#,#,#,#,#,#,#,#,#,#,#,#,
#,#,#,#,#, ,#,#,#,#,#,#,#,#,#,#,#,#,#,#,#,#,#,#,#,#,#,#,#,#,#,#,#,#,#,#,#,#,#,#,#,#,#,#,#,#,#,#,#,#,
#,#,#,#, , ,#,#,#,#,#,#,#,#,#,#,#,#, , , , ,#,#,#,#,#,#,#,#,#,#,#,#,#,#,#, , , , , , ,#,#,#,#,#,#,#,
#,#,#, , ,#,#,#,#,#,#,#,#,#,#,#,#, , , , , , ,#,#,#,#,#,#,#,#,#,#,#,#,#, , , , , , , , ,#,#,#,#,#,#,
#,#, , ,#,#,#,#,#,#,#,#, , , , , , , , , , , , ,#,#,#,#,#,#,#,#,#,#,#, , , ,#,#,#, , , , ,#,#,#,#,#,
#,#, , ,#,#,#,#,#,#,#, , , , , , , ,#,#,#,#, , ,#,#,#,#,#,#,#,#,#,#,#, , ,#,#,#,#,#, , , ,#,#,#,#,#,
#,#, , ,#,#,#,#,#,#,#, , , , , , ,#,#,#,#,#,#, ,#,#,#,#,#,#,#,#,#,#,#, , ,#,#,#,#,#, , ,#,#,#,#,#,#,
#,#, , ,#,#,#,#,#,#, , , , , , , ,#,#,#,#,#,#, , ,#,#,#,#,#,#,#,#,#,#, , ,#,#,#,#,#, , ,#,#,#,#,#,#,
#,#, , , ,#,#,#,#, , , ,#,#, , , ,#,#,#,#,#,#, , ,#,#,#,#,#,#,#,#,#,#, , , ,#,#,#, , ,#,#,#,#,#,#,#,
#,#, , , , ,#,#, , , ,#,#,#,#, , ,#,#,#,#,#, , , ,#,#,#,#,#,#,#,#,#,#, , , , , , , ,#,#,#,#,#,#,#,#,
#,#, , , , , , , , ,#,#,#,#,#, , , ,#,#, , , , ,#,#,#,#,#,#,#,#,#,#, , , , , , , ,#,#,#,#,#,#,#,#,#,
#,#,#, , , , , , , ,#,#,#,#,#, , , , , , , ,#,#,#,#,#,#,#,#,#,#,#,#, , , , , , ,#,#,#,#,#,#,#,#,#,#,
#,#,#,#, , , , , , ,#,#,#,#,#,#, , , , , ,#,#,#,#,#,#,#,#,#,#,#,#,#, , ,#, , , ,#,#,#,#,#,#,#,#,#,#,
#,#,#,#, , , , , , ,#,#,#,#,#,#,#, , , ,#,#,#,#,#,#,#,#,#,#,#,#,#,#, ,#,#,#, ,#,#,#,#,#,#,#,#,#,#,#,
#,#,#,#, , , , , , , ,#,#,#,#,#,#,#,#,#,#,#,#,#,#,#,#,#,#,#,#,#,#, , , ,#, , ,#,#,#,#,#,#,#,#,#,#,#,
#,#,#, , , ,#,#, , , ,#,#,#,#,#,#,#,#,#,#,#,#,#,#,#,#,#,#,#,#,#, , , , , , , ,#,#,#,#,#,#,#,#,#,#,#,
#,#, , ,#,#,#,#,#, , ,#,#,#,#,#,#,#,#,#,#,#,#,#,#,#,#, , , , , , , , , , , , ,#,#,#,#,#,#,#,#,#,#,#,
#, , ,#,#,#,#,#,#, , , ,#,#,#,#,#,#,#,#,#,#,#,#,#,#, , , , , , ,#,#,#, , , , ,#,#,#,#,#,#,#,#,#,#,#,
#, , ,#,#,#,#,#,#, , , ,#,#,#,#,#,#,#,#,#,#,#,#,#, , , , ,#,#,#,#,#,#,#, , ,#,#,#,#,#,#,#,#,#,#,#,#,
#,#, , ,#,#,#,#,#, , , ,#,#,#,#,#,#, , , , ,#,#, , , , ,#,#,#,#,#,#,#,#,#,#,#,#,#,#,#,#, , ,#,#,#,#,
#,#, , ,#,#,#,#,#,#, , , ,#,#,#,#, , , , , , , , , , ,#,#,#,#,#,#,#,#,#,#,#,#,#,#,#,#,#, , , ,#,#,#,
#,#,#, , ,#,#,#,#,#, , , , , , , , , , , , , , , , ,#,#,#,#,#,#,#,#,#,#,#,#,#,#,#,#,#,#,#, , , ,#,#,
#,#,#,#, , , , , , , , , , , , , , , , , , , , , , ,#,#,#,#,#,#,#,#,#,#,#,#,#,#,#,#,#,#,#,#, , ,#,#,
#,#,#,#,#, , , , , , , , , , , , , , , , , , , , , , ,#,#,#,#,#,#,#,#, , , , ,#,#,#,#,#,#,#, , ,#,#,
#,#,#,#,#,#,#, , , , , , , ,#,#,#,#,#,#, , , , , , , , , , , , , , , , , , , , ,#,#,#,#,#,#, , ,#,#,
#,#,#,#,#,#,#,#,#,#,#,#,#,#,#,#,#,#,#,#,#,#, , , , , , , , , , , , , , , , , , , ,#,#,#,#, , , ,#,#,
#,#,#,#,#,#,#,#,#,#,#,#,#,#,#,#,#,#,#,#,#,#,#, , , ,#,#, , , , ,#,#, , ,#,#, , , , , , , , , , ,#,#,
#,#,#,#,#,#,#,#,#,#,#,#,#,#,#,#,#,#,#,#,#,#,#, , ,#,#,#,#, , ,#,#,#,#,#,#,#,#, , , , , , , , ,#,#,#,
#,#,#,#,#,#,#,#,#,#,#,#,#,#,#,#,#,#,#,#,#,#, , ,#,#,#,#,#,#,#,#,#,#,#,#,#,#,#,#, , , ,#,#,#,#,#,#,#,
#,#,#,#,#,#,#,#,#,#,#,#,#, , ,#,#,#,#,#,#, , , ,#,#,#,#,#,#,#,#,#,#,#,#,#,#,#,#,#,#,#,#,#,#,#,#,#,#,
#,#,#,#,#,#,#,#,#,#,#,#, , , , , , , , , , , , ,#,#,#,#,#,#,#,#,#,#,#,#,#,#,#,#,#,#,#,#,#,#,#,#,#,#,
#,#,#,#,#,#,#,#,#,#,#, , , , , , , , , , , , , ,#,#,#,#,#,#,#,#,#,#,#,#,#,#,#,#,#,#,#,#,#,#,#,#,#,#,
#,#,#,#,#,#,#, , , , , , , , , ,#,#,#, , , , , ,#,#,#,#,#,#,#,#,#,#,#,#,#,#,#,#,#,#,#,#,#,#,#,#,#,#,
#,#,#,#,#,#, , , , , , , , , ,#,#,#,#,#, , , , , ,#,#,#,#,#,#,#,#,#,#,#,#,#,#,#,#,#,#,#,#,#,#,#,#,#,
#,#,#,#,#, , , , , , , , , , ,#,#,#,#,#, , , , , , ,#,#,#,#,#,#,#,#,#,#,#,#,#,#,#,#,#,#,#,#,#,#,#,#,
#,#,#,#, , , , , , , , , , ,#,#,#,#,#,#,#, , , , , , , , , ,#,#,#,#,#,#,#,#,#,#,#,#,#,#,#,#,#,#,#,#,
#,#,#,#, , , , , , , , , , ,#,#,#,#,#,#,#, , , , , , , , , , ,#,#,#,#,#,#,#,#,#, , , , ,#,#,#,#,#,#,
#,#,#,#, , ,#,#,#, , , , ,#,#,#,#,#,#,#,#, , , , ,#,#, , , , ,#,#,#,#,#,#, , , , , , , , ,#,#,#,#,#,
#,#,#, , ,#,#,#,#,#, , , ,#,#,#,#,#,#,#, , , , ,#,#,#,#, , , , ,#,#,#,#, , , , ,#,#,#, , , ,#,#,#,#,
#,#,#, , ,#,#,#,#,#, , ,#,#,#,#,#,#,#,#, , , , ,#,#,#,#,#, , , ,#,#,#, , , , ,#,#,#,#,#, , ,#,#,#,#,
#,#,#, , ,#,#,#,#, , ,#,#,#,#,#,#,#,#,#, , , ,#,#,#,#,#,#, , , ,#,#,#, , , , ,#,#,#,#,#, , ,#,#,#,#,
#,#, , , , ,#,#, , , ,#,#,#,#,#,#,#,#,#,#, , ,#,#,#,#,#,#,#, , , ,#, , , , , ,#,#,#,#,#, , ,#,#,#,#,
#,#, , , , , , , , ,#,#,#,#,#,#,#,#,#,#,#,#, , ,#,#,#,#,#,#, , , , , , , , , , ,#,#,#, , , ,#,#,#,#,
#,#,#, , , , , , ,#,#,#,#,#,#,#,#,#,#,#,#,#, , , ,#,#,#,#, , , , , , , , , , , , , , , , , ,#,#,#,#,
#,#,#,#,#,#,#,#,#,#,#,#,#,#,#,#,#,#,#,#,#,#, , , , ,#,#, , , , ,#,#,#,#, , , , , , , , , ,#,#,#,#,#,
#,#,#,#,#,#,#,#,#,#,#,#,#,#,#,#,#,#,#,#,#,#,#, , , , , , , , ,#,#,#,#,#,#, , , , , , , ,#,#,#,#,#,#,
#,#,#,#,#,#,#,#,#,#,#,#,#,#,#,#,#,#,#,#,#,#,#,#,#,#, , , ,#,#,#,#,#,#,#,#,#,#,#,#,#,#,#,#,#,#,#,#,#,
#,#,#,#,#,#,#,#,#,#,#,#,#,#,#,#,#,#,#,#,#,#,#,#,#,#,#,#,#,#,#,#,#,#,#,#,#,#,#,#,#,#,#,#,#,#,#,#,#,#,
#,#,#,#,#,#,#,#,#,#,#,#,#,#,#,#,#,#,#,#,#,#,#,#,#,#,#,#,#,#,#,#,#,#,#,#,#,#,#,#,#,#,#,#,#,#,#,#,#,#,
#,#,#,#,#,#,#,#,#,#,#,#,#,#,#,#,#,#,#,#,#,#,#,#,#,#,#,#,#,#,#,#,#,#,#,#,#,#,#,#,#,#,#,#,#,#,#,#,#,#,
