#,#,#,#,#,#,#,#,#,#,#,#,#,#,#,#,#,#,#,#,#,#,#,#,#,#,#,#,#,#,#,#,#,#,#,#,#,#,#,#,#,#,#,#,#,#,#,#,#,#,
#,#,#,#,#,#,#,#,#,#,#,#,#,#, , , , , ,#,#,#,#,#,#,#,#,#,#,#,#,#,#,#,#,#,#,#,#,#,#,#,#,#,#,#,#,#,#,#,
#,#,#,#,#,#,#,#,#,#,#,#,#, , , , , , , , , ,#,#,#,#,#,#,#,#,#,#,#,#,#,#,#, , , , , ,#,#,#,#,#,#,#,#,
#,#,#,#,#,#,#,#,#,#,#,#, , ,#,#,#,#,#, , , , ,#,#,#,#,#,#,#,#, , , , , , , , , , , , , , , ,#,#,#,#,
#,#,#,#,#,#,#,#,#,#,#, , ,#,#,#,#,#,#,#, , , ,#,#,#,#,#,#,#, , , , , , , , , , , , , , , , , ,#,#,#,
#,#,#, , , , , ,#,#, , ,#,#,#,#,#,#,#,#,#, , , ,#,#, , , , , , , , , , , , , , , ,#,#,#, , , ,#,#,#,
#,#, , , , , , , , , ,#,#,#,#,#,#,#,#,#,#, , , , , , , , , , , ,#,#, , , , , , ,#,#,#,#,#, , , ,#,#,
#, , , ,#,#,#,#, , ,#,#,#,#,#,#,#,#,#,#,#, , , , , , , ,#,#,#,#,#,#,#, , , , , ,#,#,#,#,#, , , ,#,#,
#, , ,#,#,#,#,#,#,#,#,#,#,#,#,#,#,#,#,#, , , , , , , ,#,#,#,#,#,#,#,#, , , , , ,#,#,#,#,#, , ,#,#,#,
#, , ,#,#,#,#,#,#,#, , , , , ,#,#,#,#, , , , , , , , ,#,#,#,#,#,#,#, , , , , , , ,#,#,#, , ,#,#,#,#,
#, , ,#,#,#,#,#,#, , , , , , , ,#,#, , , , , , , , , ,#,#,#,#,#,#, , , , , , , , , , , , ,#,#,#,#,#,
#, , ,#,#,#,#,#,#, , ,#,#,#, , , , , , , , ,#,#, , , , ,#,#,#,#, , , , , , , , , , , , ,#,#,#,#,#,#,
#, , ,#,#,#,#,#, , ,#,#,#,#,#, , , , , , ,#,#,#,#, , , , , , , , , ,#,#,#,#,#,#,#, , ,#,#,#,#,#,#,#,
#, , , ,#,#,#, , , ,#,#,#,#,#,#, , , , , ,#,#,#,#, , , , , , , , ,#,#,#,#,#,#,#,#,#,#,#,#,#,#,#,#,#,
#,#, , , , , , , ,#,#,#,#,#,#,#, , , , , ,#,#,#,#,#, , , , , , , ,#,#,#,#,#,#,#,#,#,#,#,#,#,#,#,#,#,
#,#,#, , , , , ,#,#,#,#,#,#,#, , , , , , ,#,#,#,#,#,#, , , , , ,#,#,#,#,#,#,#,#,#,#,#,#,#,#,#,#,#,#,
#,#,#,#, , , ,#,#,#,#,#,#,#, , , , , , , , ,#,#,#,#,#,#,#, , ,#,#,#,#,#,#,#,#,#,#,#,#,#,#, , , ,#,#,
#,#,#,#, , ,#,#,#,#,#,#,#, , , , ,#,#, , , , ,#,#,#,#,#,#,#,#,#,#,#,#,#,#,#,#,#,#,#,#,#, , , , ,#,#,
#,#,#,#, , ,#,#,#,#,#,#, , , , ,#,#,#,#, , , ,#,#,#,#,#,#,#,#,#,#,#,#,#,#,#,#,#,#,#,#, , , , , ,#,#,
#,#,#,#, , ,#,#,#,#,#,#, , , ,#,#,#,#,#, , , ,#,#,#,#,#,#,#,#,#,#,#,#,#,#,#,#,#,#,#,#, , , , , ,#,#,
#,#,#,#, , ,#,#,#,#,#,#, , , ,#,#,#,#,#, , , ,#,#,#,#,#,#,#,#,#,#,#,#,#,#,#,#,#,#,#, , , , , , ,#,#,
#,#,#,#,#,#,#,#,#,#,#,#, , , ,#,#,#,#,#, , , , ,#,#,#,#,#,#,#,#,#,#,#,#,#,#,#,#, , , , , , , ,#,#,#,
#,#,#,#,#,#,#,#,#,#,#,#, , , , ,#,#,#, , , , , , ,#,#,#,#,#,#,#,#,#,#,#,#,#,#, , , ,#,#,#,#,#,#,#,#,
#,#,#,#,#,#,#,#,#,#,#,#, , , , , , , , , , , , , , , ,#,#,#,#,#,#,#,#,#,#,#,#, , ,#,#,#,#,#,#,#,#,#,
#,#,#,#,#,#,#,#,#,#,#, , , , , , , , , , , , , , , , , , , , ,#,#,#,#,#,#,#, , , ,#,#,#,#,#,#,#,#,#,
#,#,#,#,#,#,#,#,#,#, , , , , , , , , , , , , , , , , , , , , , , ,#,#,#, , , , , ,#,#,#,#,#,#,#,#,#,
#,#,#,#,#,#,#,#,#, , , , , , ,#,#,#,#,#, , , , , , , , ,#,#,#, , , , , , , , , , , ,#,#,#, ,#,#,#,#,
#,#,#,#,#, , , , , , , , , ,#,#,#,#,#,#,#, , , , , , ,#,#,#,#,#, , , , , , , , , , , , , , ,#,#,#,#,
#,#,#,#,#, , , , , , , , , ,#,#,#,#,#,#,#,#, , , , , ,#,#,#,#,#,#, , , , , , , , , , , ,#,#,#,#,#,#,
#,#,#,#,#,#,#,#, , , , , , ,#,#,#,#,#,#,#,#,#, , , , ,#,#,#,#,#,#,#, , , ,#,#,#,#,#,#,#,#,#,#,#,#,#,
#,#,#,#,#,#,#,#,#, , , , , ,#,#,#,#,#,#,#,#,#,#, , , ,#,#,#,#,#,#,#, , ,#,#,#,#,#,#,#,#,#,#,#,#,#,#,
#,#,#,#,#,#,#,#,#, , , , ,#,#,#,#,#,#,#,#,#,#,#,#, , , ,#,#,#,#,#,#, , ,#,#,#,#,#,#,#,#,#,#,#,#,#,#,
#,#,#,#,#,#,#,#,#, , , ,#,#,#,#,#,#,#,#,#,#,#,#,#, , , , ,#,#,#,#,#, , ,#,#,#,#,#,#,#,#,#,#,#,#,#,#,
#,#,#,#,#,#,#,#,#, , , ,#,#,#,#,#,#,#,#,#,#,#,#,#,#, , , , , ,#,#, , , ,#,#,#,#,#,#,#,#,#,#,#,#,#,#,
#,#,#,#,#,#,#,#, , , , ,#,#,#,#,#,#,#,#,#,#,#,#,#,#,#,#,#, , , , , , , , ,#,#,#,#,#,#,#,#,#,#,#,#,#,
#,#,#,#, , , , , , , , ,#,#,#,#,#,#,#,#,#,#,#,#,#,#,#,#,#,#,#, , , , , , , ,#,#,#,#,#,#,#,#,#,#,#,#,
#,#,#, , , , , , , , , , ,#,#, , ,#,#,#,#,#,#,#,#,#,#,#,#,#,#,#, , , , , , , ,#,#,#,#,#,#,#,#,#,#,#,
#,#,#, , , , , , , , , , , , , , , ,#,#,#,#,#,#,#,#,#,#,#,#,#,#, , , , , , , , ,#,#,#,#,#,#,#,#,#,#,
#,#, , , , , , , , , , , , , , , , ,#,#,#,#,#,#,#,#,#,#,#,#,#,#, , , , , , , , , , , ,#,#,#,#,#,#,#,
#,#, , , , , , , , , , , , , , , , , ,#,#,#,#,#,#,#,#,#,#,#,#,#,#, , , , ,#,#, , , , , ,#,#,#,#,#,#,
#,#,#, , , , , , , , , , , ,#,#,#, , , ,#,#,#,#,#,#,#,#,#,#,#,#,#, , , ,#,#,#,#,#, , , ,#,#,#,#,#,#,
#,#,#,#,#,#,#,#,#,#, , , ,#,#,#,#,#, , ,#,#,#,#,#,#,#,#,#,#,#,#, , , , ,#,#,#,#,#,#, , , ,#,#,#,#,#,
#,#,#,#,#,#,#,#,#,#,#, , ,#,#,#,#,#, , ,#,#,#,#,#,#,#,#,#,#,#,#, , , , ,#,#,#,#,#,#, , , ,#,#,#,#,#,
#,#,#,#,#,#,#,#,#,#,#, , ,#,#,#,#,#, , ,#,#,#,#,#,#,#,#,#,#,#,#, , , , ,#,#,#,#,#, , , , ,#,#,#,#,#,
#,#,#,#,#,#,#,#,#,#,#,#, , ,#,#,#, , , ,#,#,#,#,#,#,#,#,#,#,#,#,#, , , , ,#,#,#, , , , ,#,#,#,#,#,#,
#,#,#,#,#,#,#,#,#,#,#,#, , , , , , , , ,#,#,#,#,#,#,#,#,#,#,#,#,#,#, , , , , , , , , ,#,#,#,#,#,#,#,
#,#,#,#,#,#,#,#,#,#,#,#,#, , , , , , ,#,#,#,#,#,#,#,#,#,#,#,#,#,#,#,#, , , , , , ,#,#,#,#,#,#,#,#,#,
#,#,#,#,#,#,#,#,#,#,#,#,#,#,#,#,#,#,#,#,#,#,#,#,#,#,#,#,#,#,#,#,#,#,#,#, , , , ,#,#,#,#,#,#,#,#,#,#,
#,#,#,#,#,#,#,#,#,#,#,#,#,#,#,#,#,#,#,#,#,#,#,#,#,#,#,#,#,#,#,#,#,#,#,#,#, , ,#,#,#,#,#,#,#,#,#,#,#,
#,#,#,#,#,#,#,#,#,#,#,#,#,#,#,#,#,#,#,#,#,#,#,#,#,#,#,#,#,#,#,#,#,#,#,#,#,#,#,#,#,#,#,#,#,#,#,#,#,#,
