#,#,#,#,#,#,#,#,#,#,#,#,#,#,#,#,#,#,#,#,#,#,#,#,#,#,#,#,#,#,#,#,#,#,#,#,#,#,#,#,#,#,#,#,#,#,#,#,#,#,
#,#,#,#,#,#,#,#,#,#,#,#,#,#,#,#,#,#, , , ,#,#,#,#,#,#,#,#,#, , , , , , ,#,#,#,#,#,#,#,#,#,#,#,#,#,#,
#,#,#,#,#,#,#,#,#,#,#,#,#,#,#,#, , , , , , ,#,#,#,#,#, , , , , , , , , , ,#,#,#,#,#,#,#,#,#,#,#,#,#,
#,#,#,#,#,#,#, , , ,#,#,#,#,#, , , , ,#,#, , , , , , , , , , ,#,#,#,#, , , ,#,#,#,#,#,#,#,#,#,#,#,#,
#,#,#,#,#,#, , , , , ,#,#,#, , , , ,#,#,#,#, , , , , , , , ,#,#,#,#,#,#, , , , , , ,#,#,#,#,#,#,#,#,
#,#,#,#,#, , , , , , , , , , , , ,#,#,#,#,#,#, , , , , , , ,#,#,#,#,#,#, , , , , , ,#,#,#,#,#,#,#,#,
#,#,#,#, , , , , , , , , , , , ,#,#,#,#,#,#,#,#, , , , , , , ,#,#,#,#, , , , , , , ,#,#,#,#,#,#,#,#,
#,#,#, , , , , , , , , , , , , ,#,#,#,#,#,#,#,#, , , , , , , , , , , , , , , , , , ,#,#,#,#,#, , ,#,
#,#, , , ,#,#, , , , , , , , , , ,#,#,#,#,#,#, , , , ,#,#,#,#, , , , , , , , , , , , ,#,#,#, , , ,#,
#,#, , ,#,#,#,#,#,#, , , , , , , , , , , , , , , , ,#,#,#,#,#,#, , , , , , , , , , , , , , , , , ,#,
#,#, , ,#,#,#,#,#,#,#, , , , , , , , , , , , , , ,#,#,#,#,#,#,#, , , , , , , , , , , , , , , , ,#,#,
#,#, , ,#,#,#,#,#,#,#, , , , ,#,#,#,#,#, , , , , ,#,#,#,#,#,#, , , ,#,#,#,#, , , , , ,#,#, , ,#,#,#,
#,#, , ,#,#,#,#,#,#, , , ,#,#,#,#,#,#,#,#, , , , ,#,#,#,#,#, , , ,#,#,#,#,#,#, , , ,#,#,#,#,#,#,#,#,
#,#, , , ,#,#,#,#, , , ,#,#,#,#,#,#,#,#,#, , , , ,#,#,#,#, , , , ,#,#,#,#,#,#, , , ,#,#,#,#,#,#,#,#,
#,#,#, , , , , , , , ,#,#,#,#,#,#,#,#,#,#, , , , ,#,#,#, , , , ,#,#,#,#,#,#,#, , , ,#,#,#,#,#,#,#,#,
#,#,#, , , , , , , ,#,#,#,#,#,#,#,#,#,#,#, , , , ,#,#,#, , , , ,#,#,#,#,#,#,#, , , ,#,#,#,#,#,#,#,#,
#,#,#,#, , , , , ,#,#,#,#,#,#,#,#,#,#,#,#, , , , , , , , , , , ,#,#,#,#,#,#,#, , ,#,#,#,#,#,#,#,#,#,
#,#,#,#, , , , ,#,#,#,#,#,#,#,#,#,#,#,#, , , , , , , , , , , , , ,#,#,#,#,#,#, , ,#,#,#,#,#,#,#,#,#,
#,#,#,#,#, , ,#,#,#,#,#,#, , , , ,#,#, , , , , , , , , , , , , , , , ,#,#,#, , , ,#,#,#,#,#,#,#,#,#,
#,#,#,#,#,#,#,#,#,#,#,#,#, , , , , , , , , , , , , , , , , , , , , , , , , , , , ,#,#,#,#,#,#,#,#,#,
#,#,#,#,#,#,#,#,#,#,#,#,#,#, , , , , , ,#,#,#,#,#, , , , , ,#,#, , , , , , , , , ,#,#,#,#,#,#,#,#,#,
#,#,#,#,#,#,#,#,#,#,#,#,#,#,#, , , , ,#,#,#,#,#,#,#, , , ,#,#,#,#,#,#,#, , , , ,#,#,#,#,#,#,#,#,#,#,
#,#,#,#,#,#,#,#,#,#,#,#,#,#,#,#, , , ,#,#,#,#,#,#,#, , , ,#,#,#,#,#,#,#,#, , ,#,#,#,#,#,#,#,#,#,#,#,
#,#,#,#,#,#,#,#,#,#,#,#,#,#,#,#, , , ,#,#,#,#,#,#, , , , ,#,#,#,#,#,#,#,#, , ,#,#,#,#,#,#,#,#,#,#,#,
#,#,#,#,#,#,#,#,#,#,#,#,#,#,#, , , , , ,#,#,#,#, , , , , ,#,#,#,#,#,#,#, , , ,#,#,#,#,#, , ,#,#,#,#,
#,#,#,#,#,#,#,#,#,#,#,#,#,#,#, , , , , , , , , , , , , , ,#,#,#,#,#,#,#, , , ,#,#,#,#,#, , ,#,#,#,#,
#,#,#,#,#,#,#,#,#,#,#,#,#,#,#,#, , , , , , , , , , , , , ,#,#,#,#,#,#,#, , , ,#,#,#,#,#, , ,#,#,#,#,
#,#,#,#,#,#,#,#,#,#,#,#,#,#,#,#,#, , , , , , , , , , , ,#,#,#,#,#,#,#,#,#, , , ,#,#,#, , , ,#,#,#,#,
#,#,#,#,#,#, , ,#,#,#,#,#,#,#,#,#,#, , , , , ,#,#,#,#,#,#,#,#,#,#,#,#,#,#, , , , , , , , , ,#,#,#,#,
#,#,#,#,#, , , , ,#,#,#,#,#,#,#,#,#,#,#,#,#,#,#,#,#,#,#,#,#,#,#,#,#,#,#, , , , , , , , , , ,#,#,#,#,
#,#,#,#,#, , , , , , ,#,#,#,#,#,#,#,#,#,#,#,#,#,#,#,#,#,#,#,#,#,#,#,#, , , , , , , , , , , ,#,#,#,#,
#,#,#,#,#, , , , , , , ,#,#,#,#,#,#,#,#,#,#,#,#,#,#,#,#,#,#,#,#,#,#, , , , , , ,#, , , , , ,#,#,#,#,
#,#,#,#, , , , , , , , ,#,#,#,#,#,#,#,#,#,#,#,#,#,#,#,#,#,#,#,#,#,#, , , , , ,#,#,#, , , , ,#,#,#,#,
#,#,#, , , , , , , , , ,#,#,#,#,#,#,#,#,#,#,#,#,#,#,#,#,#,#,#,#,#,#,#, , , , ,#,#,#, , , , ,#,#,#,#,
#,#,#, , ,#,#,#,#,#, , ,#,#,#,#,#,#,#,#, , ,#,#,#,#,#,#,#,#,#,#,#,#,#,#,#, , , ,#,#, , , ,#,#,#,#,#,
#,#, , ,#,#,#,#,#,#,#, , ,#,#,#,#,#,#, , , , , , , , , , ,#,#,#,#,#,#,#,#,#, , , , , , , ,#,#,#,#,#,
#,#, , ,#,#,#,#,#,#,#, , , , , , , , , , , , , , , , , , , ,#,#,#,#,#,#,#,#, , , , , , , ,#,#,#,#,#,
#,#, , , ,#,#,#,#,#,#, , , , , , , , ,#,#,#,#,#,#,#, , , , ,#,#,#,#,#,#,#,#, , , , , , , ,#,#,#,#,#,
#,#,#, , , ,#,#,#,#, , , , , , , , ,#,#,#,#,#,#,#,#,#, , , , ,#,#,#,#,#,#, , ,#,#, , , , ,#,#,#,#,#,
#,#,#,#, , , ,#,#, , , , , , , , , ,#,#,#,#,#,#,#,#,#,#, , , , , , , , , , ,#,#,#,#, , , ,#,#,#,#,#,
#,#,#,#,#, , , , , , , , , , , , , ,#,#,#,#,#,#,#,#,#,#, , , , , , , , , ,#,#,#,#,#,#, , ,#,#,#,#,#,
#,#,#,#,#,#, , , , , ,#,#,#,#,#, , , ,#,#,#,#,#,#,#,#,#, , , , , , , , ,#,#,#,#,#,#,#, , ,#,#,#,#,#,
#,#,#,#,#,#,#, , ,#,#,#,#,#,#,#,#, , , , ,#,#,#,#,#,#, , , , , , , , , ,#,#,#,#,#,#,#, , ,#,#,#,#,#,
#,#,#,#,#,#,#,#,#,#,#,#,#,#,#,#,#,#, , , , , , , , , , , ,#,#, , , , , , ,#,#,#,#,#,#, , ,#,#,#,#,#,
#,#,#,#,#,#,#,#,#,#,#,#,#,#,#,#,#,#,#,#, , , , , , , , ,#,#,#,#,#,#,#, , , ,#,#,#,#, , , ,#,#,#,#,#,
#,#,#,#,#,#,#,#,#,#,#,#,#,#,#,#,#,#,#,#,#, , , , , , ,#,#,#,#,#,#,#,#,#, , , , , , , , ,#,#,#,#,#,#,
#,#,#,#,#,#,#,#,#,#,#,#,#,#,#,#,#,#,#,#,#,#,#,#,#,#,#,#,#,#,#,#,#,#,#,#,#, , , , , , ,#,#,#,#,#,#,#,
#,#,#,#,#,#,#,#,#,#,#,#,#,#,#,#,#,#,#,#,#,#,#,#,#,#,#,#,#,#,#,#,#,#,#,#,#,#,#, , ,#,#,#,#,#,#,#,#,#,
#,#,#,#,#,#,#,#,#,#,#,#,#,#,#,#,#,#,#,#,#,#,#,#,#,#,#,#,#,#,#,#,#,#,#,#,#,#,#,#,#,#,#,#,#,#,#,#,#,#,
#,#,#,#,#,#,#,#,#,#,#,#,#,#,#,#,#,#,#,#,#,#,#,#,#,#,#,#,#,#,#,#,#,#,#,#,#,#,#,#,#,#,#,#,#,#,#,#,#,#,
