#,#,#,#,#,#,#,#,#,#,#,#,#,#,#,#,#,#,#,#,#,#,#,#,#,#,#,#,#,#,#,#,#,#,#,#,#,#,#,#,#,#,#,#,#,#,#,#,#,#,
#,#,#,#,#,#,#, , , , , , , ,#,#,#,#,#,#,#,#,#,#,#,#,#,#,#,#,#,#,#,#,#,#,#,#,#,#,#,#,#,#,#,#,#,#,#,#,
#,#,#,#,#,#, , , , , , , , , ,#,#,#,#,#,#,#,#,#,#,#,#,#,#,#,#,#,#,#,#,#,#,#,#,#, ,#,#,#,#,#,#,#,#,#,
#,#,#,#, , , , ,#,#,#,#, , , ,#,#,#,#,#,#,#,#,#,#,#, , , ,#,#,#,#,#,#,#,#,#,#, , , ,#,#,#,#,#,#,#,#,
#,#,#, , , , ,#,#,#,#,#,#, , ,#,#,#,#,#,#,#,#,#,#, , , , , ,#,#,#,#,#,#,#,#,#, , , ,#,#,#,#,#,#,#,#,
#,#,#, , , , ,#,#,#,#,#,#, , ,#,#,#,#,#,#,#,#,#, , , , , , , ,#,#,#,#,#,#,#,#, , ,#,#,#,#,#,#,#,#,#,
#,#,#,#, , , , ,#,#,#,#, , , ,#,#,#,#,#,#,#,#, , ,#,#,#,#, , , ,#,#, , ,#,#, , ,#,#,#,#,#,#,#,#,#,#,
#,#,#,#,#, , , , ,#,#, , , ,#,#,#,#,#,#,#,#, , ,#,#,#,#,#,#, , , , , , , , , ,#,#,#,#,#,#,#,#,#,#,#,
#,#,#,#,#, , , , , , , , , ,#,#,#,#,#,#,#,#, , ,#,#,#,#,#,#,#, , , , , , , ,#,#,#,#,#,#,#,#, ,#,#,#,
#,#,#,#, , , ,#,#, , , , ,#,#,#,#,#,#,#,#,#, , ,#,#,#,#,#,#,#, , , , , , , ,#,#,#,#,#,#,#, , , ,#,#,
#,#,#, , , , ,#,#,#, , , ,#,#,#,#,#,#,#,#,#, , ,#,#,#,#,#,#, , , , , , , , ,#,#,#,#,#,#, , , ,#,#,#,
#,#, , , , , ,#,#,#,#, , ,#,#,#,#,#,#,#,#,#, , ,#,#,#,#, , , , , ,#,#,#, , , ,#,#,#,#, , , ,#,#,#,#,
#, , , ,#,#, , ,#,#, , , ,#,#,#,#,#,#,#,#, , , , ,#,#, , , , , ,#,#,#,#,#, , , ,#,#, , , , ,#,#,#,#,
#, , ,#,#,#,#, , , , , , ,#,#,#,#,#,#,#, , , , , , , , , , ,#,#,#,#,#,#,#,#, , , , , , , , ,#,#,#,#,
#, , ,#,#,#,#, , , , , , ,#,#,#,#,#, , , , , , , , , , , ,#,#,#,#,#,#,#,#,#,#, , , , , , , ,#,#,#,#,
#, , ,#,#,#,#,#, , , , , , ,#,#, , , , , , , , , , , , , ,#,#,#,#,#,#,#,#,#,#, , , , , , , ,#,#,#,#,
#, , ,#,#,#,#,#,#,#,#, , , , , , , , , , , , , ,#,#,#, , , ,#,#,#,#,#,#,#,#,#, , , , , , ,#,#,#,#,#,
#,#, , ,#,#,#,#,#,#,#, , , , , , , , , , , , ,#,#,#,#,#, , , ,#,#,#,#,#,#,#, , , , , , , ,#,#,#,#,#,
#,#, , , ,#,#,#, , , , , , , , ,#,#,#,#, , , ,#,#,#,#,#, , , , ,#,#,#,#,#, , , , , , , , ,#,#,#,#,#,
#,#,#, , , , , , , , , , , , ,#,#,#,#,#,#, , ,#,#,#,#,#, , , , ,#,#,#,#,#, , , , , , , ,#,#,#,#,#,#,
#,#,#, , , , , , , , , , , , ,#,#,#,#,#,#,#, , ,#,#,#,#, , , , , ,#,#,#, , , , , , , ,#,#,#,#,#,#,#,
#,#, , , , , , , ,#,#, , , , , ,#,#,#,#,#,#, , ,#,#,#,#,#, , , , , , , , , , , , , , ,#,#,#,#,#,#,#,
#,#, , , , , , ,#,#,#,#, , , , , ,#,#,#,#, , , ,#,#,#,#,#,#,#,#, , , , , , ,#,#, , , ,#,#,#,#,#,#,#,
#,#,#, , , , , ,#,#,#,#,#, , , , , , , , , , , ,#,#,#,#,#,#,#,#,#, , , ,#,#,#,#,#, , ,#,#,#,#,#,#,#,
#,#,#, , , , , , ,#,#,#,#,#,#,#,#, , , , , , ,#,#,#,#,#,#,#,#,#,#, , ,#,#,#,#,#,#, , , ,#,#,#,#,#,#,
#,#,#, , , , , , , , ,#,#,#,#,#,#,#, , , , , ,#,#,#,#,#,#,#,#,#,#, , ,#,#,#,#,#,#,#, , ,#,#,#,#,#,#,
#,#, , , ,#,#,#, , , , ,#,#,#,#,#,#, , , , , ,#,#,#,#,#,#,#,#,#,#, , ,#,#,#,#,#,#,#, , ,#,#,#,#,#,#,
#,#, , ,#,#,#,#,#, , , ,#,#,#,#,#,#,#, , , ,#,#,#,#,#,#,#,#,#,#,#, , ,#,#,#,#,#,#, , , , ,#,#,#,#,#,
#, , ,#,#,#,#,#,#, , ,#,#,#,#,#,#,#,#,#,#,#,#,#,#,#,#,#,#,#,#,#,#, , , ,#,#,#,#,#, , , , ,#,#,#,#,#,
#, , ,#,#,#,#,#,#, , ,#,#,#,#,#,#,#,#,#,#,#,#,#,#,#,#,#,#,#,#,#,#,#, , , ,#,#,#,#, , , ,#,#,#,#,#,#,
#, , ,#,#,#,#,#, , , , ,#,#,#,#,#,#,#,#,#, , , , ,#,#,#,#,#,#,#,#,#,#, , , ,#,#, , , ,#,#,#,#,#,#,#,
#, , ,#,#,#,#,#, , , , ,#,#,#,#,#,#,#,#, , , , , , ,#,#,#,#,#,#,#,#,#,#, , , , , , , ,#,#,#,#,#,#,#,
#, , , ,#,#,#,#,#, , , , ,#,#,#,#,#,#, , , ,#,#, , , ,#,#,#,#,#,#,#,#,#, , , , , , , ,#,#,#,#,#,#,#,
#, , , , , ,#,#,#,#, , , ,#,#,#,#,#, , , ,#,#,#,#, , ,#,#,#,#,#,#,#,#,#, , ,#,#,#, , ,#,#,#,#,#,#,#,
#,#, , , , , ,#,#,#, , , , ,#,#, , , , , ,#,#,#,#, , , ,#,#,#,#,#,#,#,#, , , ,#, , , ,#,#,#,#,#,#,#,
#,#,#, , , , , ,#,#, , , , , , , , , , ,#,#,#,#,#, , , , ,#,#,#,#,#,#,#, , , , , , , ,#,#,#,#,#,#,#,
#,#,#, , , , , , , , , , , , , , , , ,#,#,#,#,#,#, , , , , ,#,#,#,#,#,#,#, , , , , , ,#,#,#,#,#,#,#,
#,#,#, , , , , , , , , , , , , , , ,#,#,#,#,#,#,#, , , , , ,#,#,#,#,#,#,#, , , , , , ,#,#,#,#,#,#,#,
#,#,#, , , , ,#,#, , , , , , , , , ,#,#,#,#,#,#, , , , , , ,#,#,#,#,#,#,#, , ,#,#, , , ,#,#,#,#,#,#,
#,#,#, , , ,#,#,#,#, , , , , , , , , ,#,#, , , , , , , , ,#,#,#,#,#,#,#, , ,#,#,#,#, , ,#,#,#,#,#,#,
#,#,#, , , ,#,#,#,#,#, , , , , , , , , , , , , , , , , ,#,#,#,#,#,#,#, , , ,#,#,#,#, , , ,#,#,#,#,#,
#,#,#, , ,#,#,#,#,#,#, , , , , , , , , , , , ,#,#,#,#,#,#,#,#,#,#,#, , , ,#,#,#,#,#, , , ,#,#,#,#,#,
#,#,#, , ,#,#,#,#,#,#,#, , , , , ,#,#, , , ,#,#,#,#,#,#,#,#,#,#,#, , , ,#,#,#,#,#,#, , , ,#,#,#,#,#,
#,#,#,#, ,#,#,#,#,#,#,#, , , , ,#,#,#,#,#,#,#,#,#,#,#,#,#,#,#,#, , , , ,#,#,#,#,#,#, , , ,#,#,#,#,#,
#,#,#,#, , ,#,#,#,#,#, , , , , ,#,#,#,#,#,#,#,#,#,#,#,#,#,#,#,#, , , , , ,#,#,#,#, , , ,#,#,#,#,#,#,
#,#,#, , , ,#,#,#,#, , , , , ,#,#,#,#,#,#,#,#,#,#,#,#,#,#,#,#,#,#, , , , , , , , , , ,#,#,#,#,#,#,#,
#,#,#, , , , ,#,#, , , ,#,#,#,#,#,#,#,#,#,#,#,#,#,#,#,#,#,#,#,#,#,#, , , , , , , , ,#,#,#,#,#,#,#,#,
#,#,#,#, , , , , , ,#,#,#,#,#,#,#,#,#,#,#,#,#,#,#,#,#,#,#,#,#,#,#,#,#,#,#,#, , ,#,#,#,#,#,#,#,#,#,#,
#,#,#,#,#,#, , , ,#,#,#,#,#,#,#,#,#,#,#,#,#,#,#,#,#,#,#,#,#,#,#,#,#,#,#,#,#,#,#,#,#,#,#,#,#,#,#,#,#,
#,#,#,#,#,#,#,#,#,#,#,#,#,#,#,#,#,#,#,#,#,#,#,#,#,#,#,#,#,#,#,#,#,#,#,#,#,#,#,#,#,#,#,#,#,#,#,#,#,#,
