#,#,#,#,#,#,#,#,#,#,#,#,#,#,#,#,#,#,#,#,#,#,#,#,#,#,#,#,#,#,#,#,#,#,#,#,#,#,#,#,#,#,#,#,#,#,#,#,#,#,
#,#,#,#,#,#,#,#,#, , , , , , ,#,#,#,#,#,#,#,#,#,#,#,#,#,#,#,#,#,#,#,#,#,#,#,#,#,#,#,#,#,#,#,#,#,#,#,
#,#,#,#,#,#,#,#, , , , , , , ,#,#,#,#,#,#,#,#,#,#,#,#,#,#,#,#,#,#,#,#, , ,#,#,#,#,#,#,#,#,#,#,#,#,#,
#,#,#,#,#,#,#, , , , ,#,#,#,#,#,#,#,#,#,#,#,#,#,#,#,#,#,#,#,#,#,#,#, , , , , ,#,#,#,#,#,#,#,#,#,#,#,
#,#,#,#,#,#,#, , , ,#,#,#,#,#,#,#,#,#,#,#,#,#,#,#,#,#,#,#,#,#,#,#, , , , , , , ,#,#,#,#,#,#,#,#,#,#,
#,#,#,#,#,#,#,#, , ,#,#,#,#,#,#,#,#,#,#,#,#,#,#,#,#,#,#,#,#,#,#, , , ,#,#,#, , , ,#,#,#,#,#,#,#,#,#,
#,#,#,#,#,#,#,#, , ,#,#,#,#,#, , , ,#,#,#,#,#,#,#,#,#,#,#,#,#, , , ,#,#,#,#,#, , ,#,#,#,#,#,#,#,#,#,
#,#,#,#,#,#,#, , , ,#,#,#,#, , , , , ,#,#,#,#,#,#,#,#,#,#,#,#, , , ,#,#,#,#,#, , ,#,#,#,#,#,#,#,#,#,
#,#,#,#,#,#, , , , ,#,#,#, , , , , , ,#,#,#,#,#,#,#,#,#,#,#,#, , , ,#,#,#,#,#, , ,#,#,#,#,#,#,#,#,#,
#,#,#,#,#,#, , , , ,#,#,#, , , , , ,#,#,#,#,#,#,#,#,#,#,#,#,#,#, , , ,#,#,#,#, , ,#,#,#,#,#,#,#,#,#,
#,#,#,#,#,#, , , , ,#,#,#, , , , ,#,#,#,#,#,#,#,#,#,#,#,#,#,#,#, , , ,#,#,#,#, , ,#,#,#,#,#,#,#,#,#,
#,#,#,#,#,#, , , ,#,#,#,#, , , ,#,#,#,#,#,#,#,#,#,#,#,#,#,#,#,#, , , , ,#,#, , , ,#,#,#,#,#,#,#,#,#,
#,#,#,#,#,#, , , ,#,#,#,#, , , ,#,#,#,#,#,#,#,#,#,#,#,#,#,#,#, , , , , , , , , ,#,#,#,#,#,#,#,#,#,#,
#,#,#,#,#, , , ,#,#,#,#,#, , , ,#,#,#,#,#,#,#,#,#,#,#,#, , , , , , , , , , , , ,#,#,#,#,#,#,#,#,#,#,
#,#,#,#, , , ,#,#,#,#,#,#, , , , ,#,#,#,#,#,#,#,#,#,#,#, , , , , , , , , , , , ,#,#,#,#,#,#,#,#,#,#,
#,#,#,#, , , ,#,#,#,#,#,#, , , , ,#,#,#,#,#,#,#,#,#,#,#, , , , , , , , , , , , , ,#,#,#,#,#,#,#,#,#,
#,#,#,#, , , ,#,#,#,#,#,#, , , , ,#,#,#,#,#,#,#,#,#,#,#,#,#, , ,#,#, , , , , , , ,#,#,#,#,#,#,#,#,#,
#,#,#, , , , , ,#,#,#,#,#, , , , ,#,#,#,#,#,#,#,#,#,#,#,#,#,#,#,#,#,#, , , ,#,#, , ,#,#,#,#,#,#,#,#,
#,#,#, , , , , ,#,#,#,#,#, , , ,#,#,#,#,#,#, , , ,#,#,#,#,#,#,#,#,#,#, , ,#,#,#,#, , , ,#,#,#,#,#,#,
#,#,#, , , , , , ,#,#,#, , , ,#,#,#,#,#,#, , , , ,#,#,#,#,#,#,#,#,#, , , ,#,#,#,#, , , , ,#,#,#,#,#,
#,#,#,#, , , , , , , , , , , ,#,#, , , , , , , , , ,#,#,#, , , , , , , ,#,#,#,#,#,#, , , , , ,#,#,#,
#,#,#,#,#, , , , , , , , , , , , , , , , , , , , , , , , , , , , , , ,#,#,#,#,#,#,#, , , , , , ,#,#,
#,#,#,#,#,#, , , , , ,#,#,#, , , , ,#,#,#, , , , , , , , , , , , , ,#,#,#,#,#,#,#,#, , , , , , ,#,#,
#,#,#,#,#,#, , , , ,#,#,#,#,#, , ,#,#,#,#,#,#,#, , , , , ,#,#, , , ,#,#,#,#,#,#,#,#, , , , , ,#,#,#,
#,#,#,#,#, , , , , ,#,#,#,#,#, , ,#,#,#,#,#,#,#,#, , , ,#,#,#, , , , ,#,#,#,#,#,#, , , ,#,#,#,#,#,#,
#,#,#, , , , , , , ,#,#,#,#,#, , ,#,#,#,#,#,#,#,#, , , , ,#,#, , , , , ,#,#,#, , , , ,#,#,#,#,#,#,#,
#,#, , , ,#,#, , , ,#,#,#,#,#, , ,#,#,#,#,#,#,#, , , , , , , , , , , , , , , , , , , ,#,#,#,#,#,#,#,
#, , , ,#,#,#,#, , ,#,#,#,#, , , ,#,#,#,#,#,#, , , , , , , , , , , , , , , , , , , ,#,#,#,#,#,#,#,#,
#, , ,#,#,#,#,#, , ,#,#,#, , , , , ,#,#,#,#,#, , , , , ,#,#,#,#,#,#,#,#,#,#,#,#,#,#,#,#,#,#,#,#,#,#,
#, , ,#,#,#,#,#, , ,#,#,#, , , , , ,#,#,#,#,#, , , , ,#,#,#,#,#,#,#,#,#,#,#,#,#,#,#,#,#,#,#,#,#,#,#,
#, , ,#,#,#,#, , ,#,#,#,#,#, , , ,#,#,#,#,#,#,#, , ,#,#,#,#,#,#,#,#,#,#,#,#,#,#,#,#,#,#,#,#,#,#,#,#,
#, , ,#,#,#,#, , ,#,#,#,#,#,#,#,#,#,#,#,#,#,#,#,#,#,#,#,#,#,#,#,#,#,#,#,#,#,#,#,#,#,#,#,#,#,#,#,#,#,
#, , , ,#,#, , ,#,#,#,#,#,#,#,#,#,#,#,#,#,#,#,#,#,#,#,#,#,#,#,#,#,#,#,#,#,#,#,#,#,#,#,#,#,#,#,#,#,#,
#, , , , , , , ,#,#,#,#,#,#,#,#,#,#,#,#,#,#,#,#,#,#,#,#,#,#,#,#,#,#,#,#,#,#,#,#,#,#,#, , ,#,#,#,#,#,
#,#, , , , , , ,#,#,#,#,#,#,#,#,#,#,#,#,#,#,#,#,#, , , , , ,#,#,#,#,#,#,#,#,#,#,#,#, , , , , ,#,#,#,
#,#, , , , , ,#,#,#,#,#,#,#,#,#,#,#,#,#,#,#,#,#, , , , , , , , , , ,#,#,#,#,#,#, , , , , , , , ,#,#,
#,#, , , , , ,#,#,#,#, , ,#,#,#,#,#,#,#,#,#,#,#, , , , , , , , , , , , ,#,#, , , , , ,#,#, , , ,#,#,
#,#, , , , , , ,#,#, , , , , , , , ,#,#,#,#,#,#, , , , , ,#,#,#,#, , , , , , , , ,#,#,#,#,#, , ,#,#,
#,#, , , , , , , , , , , , , , , , , ,#,#,#,#,#, , , , ,#,#,#,#,#,#, , , , , , ,#,#,#,#,#,#, , ,#,#,
#,#, , , , , , , , , , , , , ,#,#,#, , , ,#,#,#, , , ,#,#,#,#,#,#,#, , , , , ,#,#,#,#,#,#,#,#, , ,#,
#,#, , ,#,#, , , , , , , , ,#,#,#,#,#, , , ,#,#, , , ,#,#,#,#,#,#,#, , , , , ,#,#,#,#,#,#,#,#, , ,#,
#, , ,#,#,#,#, , , , , , ,#,#,#,#,#,#, , , ,#,#, , , , ,#,#,#,#,#, , , , , , , ,#,#,#,#,#,#,#, , ,#,
#, , ,#,#,#,#,#, , , , , ,#,#,#,#,#,#,#, , , , , , , , , , ,#,#, , , , , , , , , , ,#,#,#,#, , , ,#,
#, , ,#,#,#,#,#,#, , , , , ,#,#,#,#,#,#, , , , , , ,#,#, , , , , , , ,#,#,#, , , , , , , , , , ,#,#,
#, , ,#,#,#,#,#,#, , , , , , ,#,#,#,#,#, , , ,#,#,#,#,#,#, , , , ,#,#,#,#,#,#,#, , , , , , , , ,#,#,
#, , ,#,#,#,#,#, , , ,#,#, , , ,#,#,#, , , ,#,#,#,#,#,#,#,#,#,#,#,#,#,#,#,#,#,#,#,#,#,#, , , ,#,#,#,
#, , , ,#,#, , , , ,#,#,#,#, , , , , , , ,#,#,#,#,#,#,#,#,#,#,#,#,#,#,#,#,#,#,#,#,#,#,#,#,#,#,#,#,#,
#,#, , , , , , ,#,#,#,#,#,#,#, , , , , ,#,#,#,#,#,#,#,#,#,#,#,#,#,#,#,#,#,#,#,#,#,#,#,#,#,#,#,#,#,#,
#,#,#,#, , ,#,#,#,#,#,#,#,#,#,#,#,#,#,#,#,#,#,#,#,#,#,#,#,#,#,#,#,#,#,#,#,#,#,#,#,#,#,#,#,#,#,#,#,#,
#,#,#,#,#,#,#,#,#,#,#,#,#,#,#,#,#,#,#,#,#,#,#,#,#,#,#,#,#,#,#,#,#,#,#,#,#,#,#,#,#,#,#,#,#,#,#,#,#,#,
