#,#,#,#,#,#,#,#,#,#,#,#,#,#,#,#,#,#,#,#,#,#,#,#,#,#,#,#,#,#,#,#,#,#,#,#,#,#,#,#,#,#,#,#,#,#,#,#,#,#,
#,#,#,#,#,#,#,#,#,#,#,#,#,#,#,#,#,#,#, , , , , , , ,#,#,#,#,#,#,#,#,#,#,#,#,#,#,#,#,#,#,#,#,#,#,#,#,
#,#,#,#, , , , , ,#,#,#,#,#,#,#, , , , , , , , , , , , ,#,#,#,#,#,#,#,#,#,#,#,#,#,#,#,#, , , ,#,#,#,
#,#,#, , , , , , , ,#,#,#,#,#, , , , , ,#,#,#,#,#, , , , ,#,#,#,#,#,#,#,#,#,#,#, , , , , , , , ,#,#,
#,#, , ,#,#,#,#, , ,#,#,#,#,#, , , , ,#,#,#,#,#,#,#, , , ,#,#,#,#,#,#,#,#,#, , , , , , , , , , ,#,#,
#, , ,#,#,#,#,#,#, , ,#,#,#,#,#, , , ,#,#,#,#,#,#,#, , ,#,#,#,#,#,#,#,#,#, , , ,#,#,#,#, , , , ,#,#,
#, , ,#,#,#,#,#,#, , ,#,#,#,#,#,#, , ,#,#,#,#,#,#, , ,#,#,#,#,#,#,#,#,#, , , ,#,#,#,#,#,#, , , ,#,#,
#, , ,#,#,#,#,#,#, , ,#,#,#,#,#,#, , , ,#,#,#,#, , ,#,#,#,#,#,#,#,#,#, , , ,#,#,#,#,#,#,#, , , ,#,#,
#,#, , ,#,#,#,#,#,#, , ,#,#,#,#, , , , ,#,#,#, , ,#,#,#,#,#,#,#,#,#,#, , , ,#,#,#,#,#,#,#, , ,#,#,#,
#,#,#, , ,#,#,#,#,#, , , , , , , , , , ,#,#, , ,#,#,#,#,#,#,#,#,#,#,#,#, , ,#,#,#,#,#,#, , ,#,#,#,#,
#,#,#,#, , ,#,#,#, , , , , , , , , , ,#,#, , ,#,#,#,#,#,#,#,#,#,#,#,#,#, , , ,#,#,#,#, , ,#,#,#,#,#,
#,#,#,#,#, , , , , , , , , , , , , ,#,#, , , ,#,#,#,#,#,#,#,#,#,#,#,#, , , , , , , , , , ,#,#,#,#,#,
#,#,#,#,#,#, , , , , , , , ,#,#,#,#,#, , , , ,#,#,#,#,#,#,#,#,#,#,#, , , , , , , , , , ,#,#,#,#,#,#,
#,#,#,#,#,#,#, , , , , , ,#,#,#,#,#,#, , , , ,#,#,#,#,#,#,#,#,#, , , , , , , , , , ,#,#,#,#,#,#,#,#,
#,#,#,#,#,#,#,#,#,#, , , ,#,#,#,#,#,#, , , , ,#,#,#,#,#,#, , , , , , , , , , , ,#,#,#,#,#,#,#,#,#,#,
#,#,#,#,#,#,#,#,#,#,#, , ,#,#,#,#,#,#, , , ,#,#,#,#,#,#, , , , , , , , , , , ,#,#,#,#,#,#,#,#,#,#,#,
#,#,#,#,#,#,#,#,#,#,#, , , ,#,#,#,#,#, , ,#,#,#,#,#,#,#, , , ,#,#,#, , , , , ,#,#,#,#,#,#,#,#,#,#,#,
#,#,#,#,#,#,#,#,#,#, , , , ,#,#,#,#,#,#,#,#,#,#,#,#,#, , , ,#,#,#,#,#, , , , , ,#,#,#,#,#,#,#,#,#,#,
#,#,#, , , , , , , , , , , ,#,#,#,#,#,#,#,#,#,#,#,#, , , ,#,#,#,#,#,#, , , , , ,#,#,#,#,#,#,#,#,#,#,
#,#, , , , , , , , , , , , , ,#,#,#,#,#,#,#,#,#,#,#, , , ,#,#,#,#,#,#, , , , ,#,#,#,#,#,#,#,#,#,#,#,
#,#, , , , , ,#,#, , ,#,#, , , ,#,#,#,#,#,#,#,#,#,#, , , ,#,#,#,#,#, , , ,#,#,#,#,#,#,#,#,#,#,#,#,#,
#,#, , , ,#,#,#,#,#,#,#,#,#, , , ,#,#,#,#,#,#,#,#,#, , , , ,#,#,#, , , ,#,#,#,#,#,#,#,#,#,#,#,#,#,#,
#,#, , ,#,#,#,#,#,#,#,#,#,#, , , , , ,#,#,#,#,#,#, , , , , , , , , , ,#,#,#,#,#,#,#,#,#,#,#,#,#,#,#,
#,#, , ,#,#,#,#,#,#,#,#,#,#, , , , , , ,#,#,#,#, , , , , , , , , , ,#,#,#,#,#,#,#,#,#,#,#,#,#,#,#,#,
#,#, , ,#,#,#,#,#,#,#,#,#,#,#, , , , , , ,#,#,#, , , , , , , , , ,#,#,#,#,#,#,#,#,#,#,#,#,#,#,#,#,#,
#,#, , ,#,#,#,#,#, ,#,#,#,#,#,#, , , , , ,#,#,#,#, , , , , , , , ,#,#,#,#,#,#,#,#,#,#,#,#,#,#,#,#,#,
#,#, , ,#,#,#,#, , , ,#,#,#,#,#, , , , , ,#,#,#,#,#, , , , , , , ,#,#,#,#,#,#,#,#,#,#,#,#,#,#,#,#,#,
#,#, , ,#,#,#,#, , ,#,#,#,#,#,#,#, , , , ,#,#,#,#,#,#, , , , , ,#,#,#,#,#,#,#,#,#,#,#,#,#,#,#,#,#,#,
#,#,#, , ,#,#,#, , ,#,#,#,#,#,#,#, , , , ,#,#,#,#,#,#, , , ,#,#,#,#,#,#,#,#,#,#,#,#,#,#,#,#,#,#,#,#,
#,#,#,#, , , , , , ,#,#,#,#,#,#,#, , , ,#,#,#,#,#,#,#, , ,#,#,#,#,#,#,#,#,#,#,#,#,#,#,#,#,#,#,#,#,#,
#,#,#,#, , , , , , ,#,#,#,#,#,#,#, , , ,#,#,#,#,#,#,#, ,#,#,#,#,#,#,#,#,#,#,#,#,#,#,#,#,#,#,#,#,#,#,
#,#,#,#, , , , , , , ,#,#,#,#,#,#, , , , ,#,#,#,#,#, , ,#,#,#,#,#,#,#,#,#,#, , , , , , ,#,#,#,#,#,#,
#,#,#,#,#, , , , , , ,#,#,#,#,#,#,#, , , , , ,#,#, , , ,#,#,#,#,#,#,#,#,#, , , , , , , , ,#,#,#,#,#,
#,#,#,#,#, , , , , , ,#,#,#,#,#,#,#,#,#,#, , , , , , , ,#,#,#,#,#,#,#,#,#, , , ,#,#,#, , ,#,#,#,#,#,
#,#,#,#,#, , , , , , ,#,#,#,#,#,#,#,#,#,#,#, , , , , ,#,#,#,#,#,#,#,#,#, , , ,#,#,#,#,#, , ,#,#,#,#,
#,#,#,#,#, , , , , , ,#,#,#,#,#,#,#,#,#,#,#,#, , , , ,#,#,#,#,#,#,#,#,#, , , ,#,#,#,#,#, , , ,#,#,#,
#,#,#,#, , , ,#,#, , ,#,#,#,#,#,#,#,#,#,#,#,#, , , , ,#,#,#,#,#,#,#,#, , , ,#,#,#,#,#,#, , , ,#,#,#,
#,#,#, , , ,#,#,#,#, , ,#,#,#,#,#,#,#,#,#,#, , , , , , ,#,#,#,#,#, , , , , ,#,#,#,#,#,#, , , ,#,#,#,
#,#,#, , ,#,#,#,#,#, , , ,#,#,#,#,#,#,#,#, , , , , , , , ,#,#,#, , , , , , ,#,#,#,#,#, , , ,#,#,#,#,
#,#, , , ,#,#,#,#,#, , , ,#,#,#,#,#,#,#,#, , ,#,#,#, , , , ,#,#,#, , , , , , ,#,#,#, , , , ,#,#,#,#,
#,#, , , ,#,#,#,#,#,#, , ,#,#,#,#,#,#,#, , ,#,#,#,#,#, , , ,#,#,#, , , , , , , , , , , , ,#,#,#,#,#,
#,#, , , ,#,#,#,#,#,#, , ,#,#,#,#,#,#,#, , ,#,#,#,#,#,#, , ,#,#,#, , , , , , , , , , , ,#,#,#,#,#,#,
#,#,#, , , ,#,#,#,#,#, , ,#,#,#,#,#,#,#, , ,#,#,#,#,#,#, , , , , , , , , , , , , , , ,#,#,#,#,#,#,#,
#,#,#,#, , , ,#,#,#, , , , ,#,#,#,#,#,#, , ,#,#,#,#,#,#, , , , , , , , , , , , , , ,#,#,#,#,#,#,#,#,
#,#,#,#,#, , , , , , , , , , ,#,#,#,#,#, , ,#,#,#,#,#, , , , ,#,#,#,#, , , , , , ,#,#,#,#,#,#,#,#,#,
#,#,#,#,#,#, , , , , , , , , ,#,#,#,#,#, , , ,#,#,#, , , , ,#,#,#,#,#,#, , ,#,#,#,#,#,#,#,#,#,#,#,#,
#,#,#,#,#,#,#,#,#,#,#,#, , ,#,#,#,#,#,#,#, , , , , , , , ,#,#,#,#,#,#,#,#,#,#,#,#,#,#,#,#,#,#,#,#,#,
#,#,#,#,#,#,#,#,#,#,#,#,#,#,#,#,#,#,#,#,#,#, , , , , ,#,#,#,#,#,#,#,#,#,#,#,#,#,#,#,#,#,#,#,#,#,#,#,
#,#,#,#,#,#,#,#,#,#,#,#,#,#,#,#,#,#,#,#,#,#,#,#,#,#,#,#,#,#,#,#,#,#,#,#,#,#,#,#,#,#,#,#,#,#,#,#,#,#,
#,#,#,#,#,#,#,#,#,#,#,#,#,#,#,#,#,#,#,#,#,#,#,#,#,#,#,#,#,#,#,#,#,#,#,#,#,#,#,#,#,#,#,#,#,#,#,#,#,#,
