#,#,#,#,#,#,#,#,#,#,#,#,#,#,#,#,#,#,#,#,#,#,#,#,#,#,#,#,#,#,#,#,#,#,#,#,#,#,#,#,#,#,#,#,#,#,#,#,#,#,
#,#,#,#,#,#,#,#,#,#,#,#,#,#,#,#,#,#,#,#,#,#,#, , ,#,#,#,#,#,#,#,#,#,#,#,#,#,#,#,#,#,#,#,#,#,#,#,#,#,
#,#,#,#,#,#,#,#,#,#,#,#,#,#,#,#,#,#,#,#,#,#, , , , , ,#,#,#,#,#,#,#, , , , , , ,#,#,#,#,#,#,#,#,#,#,
#,#,#,#,#, , , ,#,#, , , ,#,#,#,#,#,#,#,#, , , , , , , , ,#,#,#,#, , , , , , , , , ,#,#,#,#,#,#,#,#,
#,#,#,#, , , , , , , , , ,#,#,#,#,#,#,#, , , ,#,#,#,#, , , , , , , , , ,#, , , , , , ,#,#,#,#,#,#,#,
#,#,#, , , , , , , , , ,#,#,#,#,#,#,#, , , ,#,#,#,#,#,#,#, , , , , , , ,#, , , , , , ,#,#,#,#,#,#,#,
#,#, , , ,#,#,#, , , , ,#,#,#,#,#,#,#, , ,#,#,#,#,#,#,#,#,#, , , , , , , , , , , , , , ,#,#,#,#,#,#,
#,#, , ,#,#,#,#,#, , , ,#,#,#,#,#,#,#, , ,#,#,#,#,#,#,#,#,#, , , , , , , , , , , , , , , ,#,#,#,#,#,
#,#, , ,#,#,#,#,#, , ,#,#,#,#,#,#,#,#,#, , ,#,#,#,#,#,#,#, , , , , , , , , , ,#,#,#,#, , , ,#,#,#,#,
#,#, , ,#,#,#,#,#, , ,#,#,#,#,#,#,#,#,#,#, , ,#,#, , , , , , , , , , , , , ,#,#,#,#,#,#, , , ,#,#,#,
#,#,#, , ,#,#,#, , , ,#,#,#,#,#,#,#,#,#,#, , , , , , , , , , , , , , , , , ,#,#,#,#,#,#, , , ,#,#,#,
#,#,#,#, , , , , , , , ,#,#,#,#,#,#,#,#,#, , , , , , , ,#,#,#, , , , , , , , ,#,#,#,#,#, , ,#,#,#,#,
#,#,#,#,#, , , , , , , , ,#,#,#,#,#,#,#, , , , , , , ,#,#,#,#,#, , , , , , , , ,#,#,#, , ,#,#,#,#,#,
#,#,#,#,#,#,#,#, , ,#,#, , , ,#,#,#,#,#, , , , , , ,#,#,#,#,#,#,#,#,#,#,#, , , , , , , , ,#,#,#,#,#,
#,#,#,#,#,#,#,#,#,#,#,#,#, , , , ,#,#, , , , , , ,#,#,#,#,#,#,#,#,#,#,#,#,#, , , , , , ,#,#,#,#,#,#,
#,#,#,#,#,#,#,#,#,#,#,#,#,#, , , , , , , , , , ,#,#,#,#,#,#,#,#,#,#,#,#,#,#,#,#, , , , ,#,#,#,#,#,#,
#,#,#,#,#,#,#,#,#,#,#,#,#,#,#, , , , , , , , ,#,#,#,#,#,#,#,#,#,#,#,#,#,#,#,#,#,#, , , ,#,#,#,#,#,#,
#,#,#,#,#,#,#,#,#, , ,#,#,#,#,#,#,#,#,#,#, , ,#,#,#,#,#,#,#,#,#,#,#,#,#,#,#,#,#,#, , , , ,#,#,#,#,#,
#,#,#,#,#,#,#,#,#, , ,#,#,#,#,#,#,#,#,#,#,#, , ,#,#,#,#,#,#,#,#,#,#,#,#,#,#,#,#,#, , , , ,#,#,#,#,#,
#,#,#,#,#,#,#,#,#,#, , ,#,#,#,#,#,#,#,#,#,#, , ,#,#,#,#,#,#,#,#,#,#,#,#,#,#,#,#,#,#, , , ,#,#,#,#,#,
#,#,#,#,#,#,#,#,#,#, , , , , ,#,#,#,#,#,#,#, , , ,#,#,#,#,#,#,#,#,#,#,#,#,#,#,#,#,#,#,#,#,#,#,#,#,#,
#,#, , ,#,#,#,#,#, , , , , , ,#,#,#,#,#,#,#,#, , , , , , , , , , , ,#,#,#,#,#,#,#,#,#,#,#,#,#,#,#,#,
#, , , , , , , , , , , , , , ,#,#,#,#,#,#,#,#,#, , , , , , , , , , , ,#,#,#,#,#,#,#,#,#,#,#,#,#,#,#,
#, , , , , , , , , , , , , , , ,#,#,#,#,#,#,#,#,#,#,#, , , ,#,#,#, , , ,#,#,#,#,#,#,#,#,#,#,#,#,#,#,
#, , , , , , , , , ,#, , , , , , ,#,#,#,#,#,#,#,#,#,#,#,#,#,#,#,#,#, , , ,#,#,#,#,#,#,#,#,#,#,#,#,#,
#, , , ,#,#,#, , , , , , , , , , , ,#,#,#,#,#,#,#,#,#,#,#,#,#,#,#,#,#, , , ,#,#,#,#,#,#,#,#,#,#,#,#,
#, , ,#,#,#,#,#, , , , ,#,#,#, , ,#,#,#,#,#,#,#,#, , , ,#,#,#,#,#,#,#, , , ,#,#,#,#,#,#,#,#,#,#,#,#,
#, , ,#,#,#,#,#, , , ,#,#,#,#,#,#,#,#,#,#,#,#,#,#, , , , ,#,#,#,#,#,#, , , ,#,#,#,#,#,#,#,#,#,#,#,#,
#, , ,#,#,#,#,#, , , ,#,#,#,#,#,#,#,#,#,#,#,#,#,#,#, , , ,#,#,#,#,#,#, , , ,#,#,#,#,#,#,#,#,#,#,#,#,
#, , , ,#,#,#,#, , , ,#,#,#,#,#,#,#,#,#,#,#,#,#,#,#, , , , ,#,#,#,#, , , , ,#,#,#,#,#,#,#,#,#,#,#,#,
#,#, , , ,#,#, , , ,#,#,#,#,#,#,#,#,#,#,#,#,#,#,#,#, , , , , ,#,#, , , , , , ,#,#,#,#,#,#,#,#,#,#,#,
#,#,#, , , , , , , ,#,#,#,#,#,#,#,#,#,#,#,#,#,#,#,#,#, , , , , , , , , , , , , , , , , , , , ,#,#,#,
#,#,#, , , , , , ,#,#,#,#,#,#,#,#,#,#,#,#,#,#,#,#,#,#,#, , , , , , , ,#,#,#, , , , , , , , , , ,#,#,
#,#,#, , , , , ,#,#,#,#,#,#,#,#,#,#,#,#,#,#,#,#,#,#,#,#,#,#, , , , ,#,#,#,#, , , ,#,#,#,#, , , ,#,#,
#,#,#, , , ,#,#,#,#,#,#,#,#,#,#,#,#,#,#,#,#,#,#,#,#,#,#,#,#,#,#,#,#,#,#,#,#, , ,#,#,#,#,#,#, , ,#,#,
#,#,#, , , ,#,#,#,#,#,#,#,#,#, , , , , ,#,#,#,#,#,#,#,#,#,#,#,#,#,#,#,#,#, , , ,#,#,#,#,#,#,#, ,#,#,
#,#, , , , ,#,#,#,#,#,#,#,#, , , , , , , , ,#,#,#,#,#,#,#,#,#,#,#,#,#,#,#, , ,#,#,#,#,#,#,#,#, , ,#,
#, , , , , , , , ,#,#,#,#, , ,#,#,#,#, , , , ,#,#,#,#,#,#,#,#,#,#,#,#,#, , , ,#,#,#,#,#,#,#,#, , ,#,
#, , , , , , , , , ,#,#, , ,#,#,#,#,#,#,#, , , , , , , , , , , ,#,#,#, , , , , ,#,#,#,#,#,#, , , ,#,
#, , , , , , , , , , , , ,#,#,#,#,#,#,#,#,#, , , , , , , , , , , , , , , , , , , , , , , , , , ,#,#,
#, , , ,#,#,#, , , , , , ,#,#,#,#,#,#,#,#,#, , , , , , , ,#,#, , , , , , , , , , , , , , , , ,#,#,#,
#, , ,#,#,#,#,#, , , , , , ,#,#,#,#,#,#,#, , , , , , , ,#,#,#,#,#, , , , , , , ,#,#,#,#,#,#,#,#,#,#,
#, , ,#,#,#,#,#, , , , , , , , , , , , , , , , , , , ,#,#,#,#,#,#,#, , , , , ,#,#,#,#,#,#,#,#,#,#,#,
#, , ,#,#,#,#,#, , , , , , , , , , , , , , , ,#,#, , ,#,#,#,#,#,#,#, , , ,#,#,#,#,#,#,#,#,#,#,#,#,#,
#, , , ,#,#,#, , , ,#,#,#, , , , , , ,#,#,#,#,#,#,#, , ,#,#,#,#,#,#, , ,#,#,#,#,#,#,#,#,#,#,#,#,#,#,
#,#, , , , , , , ,#,#,#,#,#, , , , ,#,#,#,#,#,#,#,#, , ,#,#,#,#,#, , ,#,#,#,#,#,#,#,#,#,#,#,#,#,#,#,
#,#,#, , , , , ,#,#,#,#,#,#,#, , ,#,#,#,#,#,#,#,#,#, , , ,#,#,#, , , ,#,#,#,#,#,#,#,#,#,#,#,#,#,#,#,
#,#,#,#,#,#,#,#,#,#,#,#,#,#,#,#,#,#,#,#,#,#,#,#,#,#,#, , , , , , , ,#,#,#,#,#,#,#,#,#,#,#,#,#,#,#,#,
#,#,#,#,#,#,#,#,#,#,#,#,#,#,#,#,#,#,#,#,#,#,#,#,#,#,#,#, , , , ,#,#,#,#,#,#,#,#,#,#,#,#,#,#,#,#,#,#,
#,#,#,#,#,#,#,#,#,#,#,#,#,#,#,#,#,#,#,#,#,#,#,#,#,#,#,#,#,#,#,#,#,#,#,#,#,#,#,#,#,#,#,#,#,#,#,#,#,#,
