#,#,#,#,#,#,#,#,#,#,#,#,#,#,#,#,#,#,#,#,#,#,#,#,#,#,#,#,#,#,#,#,#,#,#,#,#,#,#,#,#,#,#,#,#,#,#,#,#,#,
#,#,#,#,#,#,#,#,#,#,#,#,#,#,#,#,#,#,#,#,#,#,#,#,#,#,#,#,#,#,#,#,#,#,#,#,#,#,#,#,#,#,#,#,#,#,#,#,#,#,
#,#,#,#,#,#, , , , ,#,#,#,#,#,#,#,#,#,#,#,#,#,#,#,#,#,#,#,#,#,#,#,#,#,#, , , , ,#,#,#,#,#,#,#,#,#,#,
#,#,#,#,#, , , , , , , , , ,#,#,#,#,#,#,#,#,#,#,#,#,#,#,#,#,#,#,#,#,#, , , , , , ,#,#,#,#,#,#,#,#,#,
#,#,#,#,#, , , ,#,#,#, , , ,#,#,#,#,#,#,#,#,#,#,#,#,#,#,#,#,#,#,#,#,#, , , , , , , ,#,#,#,#,#,#,#,#,
#,#,#,#,#, , ,#,#,#,#,#, , ,#,#,#,#,#,#,#,#,#,#,#,#,#,#,#,#,#,#,#,#,#, , , , , , , ,#,#,#,#,#,#,#,#,
#,#,#,#,#, , ,#,#,#,#,#,#,#,#,#,#,#,#,#,#,#,#,#,#,#,#,#,#,#,#,#,#,#,#, , , , , , , ,#,#,#,#,#,#,#,#,
#,#,#,#, , , ,#,#,#,#,#,#,#,#,#,#,#,#,#,#,#,#,#,#,#, , ,#,#,#,#,#,#,#, , , , , , , , ,#,#,#,#,#,#,#,
#,#,#,#, , , ,#,#,#,#,#,#,#,#,#,#,#,#,#,#,#,#,#,#,#, , , ,#,#,#,#,#,#, , , , , , , , , , ,#,#,#,#,#,
#,#,#,#, , , ,#,#,#,#,#,#,#,#,#,#,#,#,#,#,#,#,#,#,#,#, , , , ,#,#,#, , , , , , ,#,#,#, , , , ,#,#,#,
#,#,#,#, , , , ,#,#,#,#,#,#,#,#,#,#,#,#,#,#,#,#,#,#,#, , , , , , , , , , , , ,#,#,#,#,#, , , , ,#,#,
#,#,#,#, , , , ,#,#,#,#,#,#,#,#,#,#,#,#,#,#,#,#,#,#,#, , , , , , ,#,#,#, , , ,#,#,#,#,#,#, , , ,#,#,
#,#,#,#,#, , ,#,#,#,#,#,#,#,#,#,#,#,#,#,#,#,#,#,#,#,#, , , , ,#,#,#,#,#,#, , , ,#,#,#,#,#, , ,#,#,#,
#,#,#,#,#, , ,#,#,#,#,#,#,#,#,#,#,#,#,#,#,#,#,#,#,#,#, , , ,#,#,#,#,#,#,#,#, , ,#,#,#,#,#, , ,#,#,#,
#,#,#,#,#, , ,#,#,#,#,#,#,#,#,#,#,#,#,#,#,#,#,#,#,#, , , ,#,#,#,#,#,#,#,#,#, , ,#,#,#,#,#, , ,#,#,#,
#,#,#,#,#, , ,#,#,#,#,#,#,#, , ,#,#,#,#,#,#,#,#,#,#, , , ,#,#,#,#,#,#,#,#,#, , ,#,#,#,#, , , ,#,#,#,
#,#,#,#, , ,#,#,#,#,#, , ,#, , , ,#,#,#,#,#,#,#,#,#, , , ,#,#,#,#,#,#,#,#,#, , , ,#,#, , , ,#,#,#,#,
#,#,#,#, , ,#,#,#,#,#, , ,#,#, , , ,#,#,#,#,#,#,#,#, , , , ,#,#,#,#,#,#,#,#,#, , , , , , , ,#,#,#,#,
#,#,#, , , ,#,#,#,#,#, , ,#,#,#, , , , , , ,#,#,#, , , , , , ,#,#,#,#,#,#,#,#, , , , , , ,#,#,#,#,#,
#,#, , , , ,#,#,#,#,#, , ,#,#,#,#,#, , , , , , , , , , , , , , , , ,#,#,#,#, , , , , , , ,#,#,#,#,#,
#,#, , , , ,#,#,#,#,#, , ,#,#,#,#,#,#, , , , , , , , , , , , , , , , ,#,#, , , , , , , , ,#,#,#,#,#,
#, , , , , ,#,#,#,#, , , ,#,#,#,#,#,#,#, , , , , , ,#,#, , , , , , , , , , , , , , , , , , ,#,#,#,#,
#, , , , ,#,#,#,#,#, , , ,#,#,#,#,#,#,#,#,#,#,#,#,#,#,#,#, , , , , , , , , , , , , , , , , ,#,#,#,#,
#, , , ,#,#,#,#,#,#, , , , ,#,#,#, , , ,#,#,#,#,#,#,#,#,#, , , , , , , , , , , , , , , , , ,#,#,#,#,
#, , ,#,#,#,#,#,#,#, , , , , , , , , , , , ,#,#,#,#,#,#,#,#, , , , , , , , , , ,#,#, , , ,#,#,#,#,#,
#, , ,#,#,#,#,#,#, , , , , , , , , , , , , , ,#,#,#,#,#,#,#, , , , , , , , , ,#,#,#,#, , ,#,#,#,#,#,
#, , ,#,#,#,#,#, , , , , , , , ,#,#,#,#, , , , ,#,#,#,#,#, , , , , , , , , ,#,#,#,#,#,#, , ,#,#,#,#,
#, , ,#,#,#,#, , , , , , , , ,#,#,#,#,#,#, , , , ,#,#, , , , , , , , , , , ,#,#,#,#,#,#, , , ,#,#,#,
#, , ,#,#,#,#, , , , , , , , ,#,#,#,#,#,#,#, , , , , , , ,#,#, , , , , , , ,#,#,#,#,#, , , , ,#,#,#,
#,#, , ,#,#,#, , , , , , , , ,#,#,#,#,#,#,#, , , , , , ,#,#,#,#,#, , , , , , ,#,#,#,#, , , , ,#,#,#,
#,#, , , , , , , , , , , , ,#,#,#,#,#,#,#,#, , , , , ,#,#,#,#,#,#,#,#,#,#, , , ,#,#, , , , ,#,#,#,#,
#,#,#, , , , , , , ,#,#,#,#,#,#,#,#,#,#,#,#,#, , , ,#,#,#,#,#,#,#,#,#,#,#,#, , ,#,#, , , ,#,#,#,#,#,
#,#,#, , , , , , ,#,#,#,#,#,#,#,#,#,#,#,#,#,#,#,#,#,#,#,#,#,#,#,#,#,#,#,#,#, , ,#,#, , ,#,#,#,#,#,#,
#,#,#,#, , , , , ,#,#,#,#,#,#,#,#,#,#,#,#,#,#,#,#,#,#,#,#,#,#,#,#,#,#,#,#,#, , ,#,#, , ,#,#,#,#,#,#,
#,#,#,#, , , , , ,#,#,#,#,#,#,#,#,#,#,#,#,#,#,#,#,#,#,#,#,#,#,#,#,#,#,#,#,#, , ,#,#,#, , ,#,#,#,#,#,
#,#,#, , , , , , ,#,#,#,#,#,#,#,#,#,#,#,#,#,#,#,#,#,#,#,#,#,#,#,#,#,#,#,#,#, , , ,#,#, , ,#,#,#,#,#,
#,#,#, , , , , , , ,#,#,#,#,#,#,#,#,#,#,#,#, , , , ,#,#,#,#,#,#,#,#,#,#,#, , , , ,#,#, , ,#,#,#,#,#,
#,#, , , , , , , , , ,#,#,#,#,#,#,#,#,#,#, , , , , , ,#,#,#,#,#,#,#,#,#,#, , , , ,#,#, , ,#,#,#,#,#,
#,#, , , , ,#,#,#, , , ,#,#,#,#,#, , , , , , ,#,#,#, , ,#,#,#,#,#,#,#,#, , , , , ,#,#, , ,#,#,#,#,#,
#,#, , , ,#,#,#,#,#, , , ,#,#,#, , , , , , ,#,#,#,#,#, , ,#,#,#,#,#,#,#, , , , ,#,#,#, , , ,#,#,#,#,
#, , , ,#,#,#,#,#,#,#, , , , , , , , , , ,#,#,#,#,#,#, , ,#,#,#,#,#,#,#, , , ,#,#,#,#,#, , , , ,#,#,
#, , , ,#,#,#,#,#,#,#, , , , , , , , , ,#,#,#,#,#,#,#, , ,#,#,#,#,#,#,#, , ,#,#,#,#,#,#, , , , , ,#,
#, , , ,#,#,#,#,#,#, , , , , , , , , , ,#,#,#,#,#,#, , , ,#,#,#,#,#,#,#, , ,#,#,#,#,#,#, , , , , ,#,
#, , , , ,#,#,#,#, , , , , , , , , , , , ,#,#,#,#, , , , ,#,#,#,#,#,#,#,#,#,#,#,#,#,#, , , , , ,#,#,
#,#, , , , , , , , , , , , , , , , , , , , , , , , , , , ,#,#,#,#,#,#,#,#,#,#,#,#,#, , , , , ,#,#,#,
#,#,#, , , , , , , , ,#,#,#,#, , , , , , , , , , , , , , ,#,#,#,#,#,#,#,#,#,#,#,#,#, , , , ,#,#,#,#,
#,#,#,#, , , , , , ,#,#,#,#,#,#, , , , ,#,#,#,#, , , , , ,#,#,#,#,#,#,#,#,#,#,#,#,#,#, , ,#,#,#,#,#,
#,#,#,#,#, , , , ,#,#,#,#,#,#,#,#, , ,#,#,#,#,#,#,#, , ,#,#,#,#,#,#,#,#,#,#,#,#,#,#,#,#,#,#,#,#,#,#,
#,#,#,#,#,#,#,#,#,#,#,#,#,#,#,#,#,#,#,#,#,#,#,#,#,#,#,#,#,#,#,#,#,#,#,#,#,#,#,#,#,#,#,#,#,#,#,#,#,#,
#,#,#,#,#,#,#,#,#,#,#,#,#,#,#,#,#,#,#,#,#,#,#,#,#,#,#,#,#,#,#,#,#,#,#,#,#,#,#,#,#,#,#,#,#,#,#,#,#,#,
