#,#,#,#,#,#,#,#,#,#,#,#,#,#,#,#,#,#,#,#,#,#,#,#,#,#,#,#,#,#,#,#,#,#,#,#,#,#,#,#,#,#,#,#,#,#,#,#,#,#,
#,#,#,#,#,#, , , , , , ,#,#,#,#,#,#,#,#,#,#,#,#,#,#,#,#,#,#,#,#,#,#,#,#, , , , , , , , ,#,#,#,#,#,#,
#,#,#,#,#, , , , , , , , , ,#,#,#,#,#,#,#,#,#,#,#,#,#,#,#,#,#,#,#,#,#, , , , , , , , , , ,#,#,#,#,#,
#,#,#,#, , , ,#,#,#,#, , , , , ,#,#,#,#,#,#,#,#,#,#,#,#,#,#,#,#,#,#,#, , , , ,#,#,#, , , , ,#,#,#,#,
#,#,#,#, , ,#,#,#,#,#,#, , , , , , , , ,#,#,#,#,#,#,#,#,#,#,#,#,#,#,#, , , ,#,#,#,#,#, , , , ,#,#,#,
#,#,#,#, , ,#,#,#,#,#,#, , , ,#,#, , , , ,#,#,#,#,#,#,#,#,#,#,#,#,#,#, , , ,#,#,#,#,#, , , , ,#,#,#,
#,#,#,#,#, , ,#,#,#,#, , , ,#,#,#,#, , , , ,#,#,#,#,#,#,#,#,#,#,#,#,#,#, , ,#,#,#,#,#, , , ,#,#,#,#,
#,#,#,#,#, , , , , , , , ,#,#,#,#,#,#, , , , ,#,#,#,#,#,#,#,#,#,#,#,#,#, , , ,#,#,#, , , ,#,#,#,#,#,
#,#,#,#,#,#, , , , , ,#,#,#,#,#,#,#,#,#, , , , , , , ,#,#,#,#,#,#,#,#,#,#, , , ,#, , , ,#,#,#,#,#,#,
#,#,#,#,#,#, , , , ,#,#,#,#,#,#,#,#,#,#, , , , , , , , ,#,#,#,#,#,#,#,#,#, , , , , , , ,#,#,#,#,#,#,
#,#,#,#,#, , , , ,#,#,#,#,#,#,#,#,#,#, , , , ,#,#,#, , , ,#,#,#,#,#,#,#,#,#, , , , , , ,#,#,#,#,#,#,
#,#,#,#,#, , , , ,#,#,#,#,#,#,#,#,#, , , , ,#,#,#,#,#, , , ,#,#,#,#,#,#,#,#, , , , , , ,#,#,#,#,#,#,
#,#,#,#,#, , , ,#,#,#,#,#,#,#,#,#, , , , ,#,#,#,#,#,#, , , ,#,#,#,#,#,#,#,#, , , , , , ,#,#,#,#,#,#,
#,#,#,#,#, , ,#,#,#,#,#,#,#,#, , , , , ,#,#,#,#,#,#,#, , ,#,#,#,#,#,#,#,#,#, , , , , , ,#,#,#,#,#,#,
#,#,#,#,#, , ,#,#,#,#,#,#,#,#, , , ,#,#,#,#,#,#,#,#,#, , ,#,#,#,#,#,#,#,#,#, , , ,#,#, , ,#,#,#,#,#,
#,#,#,#, , , ,#,#,#,#,#,#,#,#,#,#,#,#,#,#,#,#,#,#,#, , , ,#,#,#,#,#,#,#,#, , , , , , , , ,#,#,#,#,#,
#,#,#,#, , ,#,#,#,#,#,#,#,#,#,#,#,#,#, , , , , , , , , , ,#,#,#,#,#,#,#, , , , , , , , , ,#,#,#,#,#,
#,#,#, , ,#,#,#,#,#,#,#,#, , , , , , , , , , , , , , , ,#,#,#,#,#,#,#,#, , , , , , , , ,#,#,#,#,#,#,
#,#, , , ,#,#,#,#,#,#, , , , , , , ,#,#,#,#,#, , ,#,#,#,#,#,#,#,#,#,#,#, , , ,#,#, , , ,#,#,#,#,#,#,
#,#, , , , ,#,#,#,#, , , , , ,#,#,#,#,#,#,#,#,#,#,#,#,#,#,#,#,#,#,#,#,#, , ,#,#,#,#, , , ,#,#,#,#,#,
#,#, , , , , ,#,#, , , , , ,#,#,#,#,#,#,#,#,#,#,#,#,#,#,#,#,#,#,#,#,#,#, , ,#,#,#,#,#, , ,#,#,#,#,#,
#,#,#, , , , , , , , , , , ,#,#,#,#,#,#,#,#,#,#,#,#,#,#,#,#,#,#,#,#,#, , , ,#,#,#,#,#,#, , ,#,#,#,#,
#,#,#,#, , , , , , , , , , , ,#,#,#,#,#,#,#,#,#,#,#,#,#,#,#,#,#,#,#,#, , , ,#,#,#,#,#,#, , ,#,#,#,#,
#,#,#,#,#, , , , , , , , , , , ,#,#,#,#,#,#,#,#,#,#,#,#,#,#,#,#,#,#,#, , , , ,#,#,#,#, , , ,#,#,#,#,
#,#,#,#,#, , , , , , ,#,#, , , ,#,#,#,#,#,#,#,#,#,#,#,#,#,#,#,#,#,#,#, , , , , , , , , , ,#,#,#,#,#,
#,#,#,#,#,#, , , , ,#,#,#,#, ,#,#,#,#,#,#,#,#,#,#,#,#,#,#,#,#,#,#,#,#, , , , , , , , ,#,#,#,#,#,#,#,
#,#,#,#,#,#,#,#, , ,#,#,#,#,#,#,#,#,#,#,#,#,#,#,#,#,#,#,#,#,#,#,#,#, , , , ,#,#, , ,#,#,#,#,#,#,#,#,
#,#,#,#,#,#,#,#,#, , ,#,#,#,#,#,#,#,#,#,#,#,#,#,#,#,#,#,#,#,#,#,#, , , , ,#,#,#,#,#,#,#,#,#,#,#,#,#,
#,#,#,#,#,#,#,#,#, , ,#,#,#,#,#,#,#,#,#,#,#,#,#,#,#,#,#,#,#,#, , , , , , , ,#,#,#,#,#,#,#,#,#,#,#,#,
#,#,#,#,#,#,#,#,#, , ,#,#,#,#,#,#,#,#,#,#,#,#,#,#,#,#,#,#,#, , , , , , , , , ,#,#,#,#,#,#,#,#,#,#,#,
#,#,#,#,#,#,#,#,#, , ,#,#,#,#,#,#,#,#,#,#,#,#,#,#,#,#,#,#, , , , ,#,#,#, , , ,#,#,#,#,#,#,#,#,#,#,#,
#,#,#,#,#,#,#,#,#, ,#,#,#,#,#,#,#,#,#, , ,#,#,#,#,#,#,#, , , , ,#,#,#,#,#, , ,#,#,#,#,#,#,#,#,#,#,#,
#,#,#, , ,#,#,#, , ,#,#,#,#,#,#,#,#, , , , , , , ,#,#, , , , ,#,#,#,#,#,#, , ,#,#,#,#,#,#,#,#,#,#,#,
#,#,#, , , , , , , ,#,#,#,#,#,#,#, , , , , , , , , , , , , ,#,#,#,#,#,#,#, ,#,#,#, , ,#,#,#,#,#,#,#,
#,#,#, , , , , , ,#,#,#,#,#,#,#, , , ,#,#,#,#, , , , , , , ,#,#,#,#,#,#, , , ,#, , ,#,#,#,#,#,#,#,#,
#,#,#,#, , , , , ,#,#,#,#,#,#, , , ,#,#,#,#,#,#, , , , , , , ,#,#,#,#, , , , , , , ,#,#,#,#,#,#,#,#,
#,#,#,#,#, , , , , ,#,#,#,#, , , , ,#,#,#,#,#,#, , , , , , , , , , , , , , , , , , ,#,#,#,#,#,#,#,#,
#,#,#,#,#, , , , , , , , , , , , , , ,#,#,#,#,#, , , , , , , , , , , , , , , , , , , ,#,#,#,#,#,#,#,
#,#,#,#, , , , , , , , , , , , , , , ,#,#,#,#,#, , , , , , , ,#,#, , , , , , , , , , ,#,#,#,#,#,#,#,
#,#,#,#, , , , ,#,#,#, , , , , , , , ,#,#,#,#, , , , , ,#,#,#,#,#,#, , , , , , ,#,#,#,#,#,#,#,#,#,#,
#,#,#,#, , , ,#,#,#,#,#, , , , , , , , ,#,#, , , , , ,#,#,#,#,#,#,#, , , , , ,#,#,#,#,#,#,#,#,#,#,#,
#,#,#,#, , ,#,#,#,#,#,#,#, , , , , , , , , , , , , , ,#,#,#,#,#,#,#, , , , ,#,#,#,#,#,#,#,#,#,#,#,#,
#,#,#, , , ,#,#,#,#,#,#,#, , , , , , , , , , , , , , ,#,#,#,#,#,#,#, , , ,#,#,#,#,#,#,#,#,#,#,#,#,#,
#,#,#, , ,#,#,#,#,#,#,#, , , , , , ,#,#, , , ,#,#, , ,#,#,#,#,#,#,#,#, , ,#,#,#,#,#,#,#,#,#,#,#,#,#,
#,#,#, , ,#,#,#,#,#,#, , , ,#,#,#,#,#,#,#, , , , , , ,#,#,#,#,#,#,#,#, , , ,#,#,#,#,#,#,#,#,#,#,#,#,
#,#,#, , , ,#,#,#,#, , , ,#,#,#,#,#,#,#,#, , , , , , ,#,#,#,#,#,#,#,#,#, , , , , ,#,#,#,#,#,#,#,#,#,
#,#,#,#, , , ,#,#, , , ,#,#,#,#,#,#,#,#,#,#, , , , , ,#,#,#,#,#,#,#,#,#,#, , , , ,#,#,#,#,#,#,#,#,#,
#,#,#,#,#, , , , , , ,#,#,#,#,#,#,#,#,#,#,#,#, , , ,#,#,#,#,#,#,#,#,#,#,#,#,#, , ,#,#,#,#,#,#,#,#,#,
#,#,#,#,#,#,#,#, , ,#,#,#,#,#,#,#,#,#,#,#,#,#,#,#,#,#,#,#,#,#,#,#,#,#,#,#,#,#,#,#,#,#,#,#,#,#,#,#,#,
#,#,#,#,#,#,#,#,#,#,#,#,#,#,#,#,#,#,#,#,#,#,#,#,#,#,#,#,#,#,#,#,#,#,#,#,#,#,#,#,#,#,#,#,#,#,#,#,#,#,
