#,#,#,#,#,#,#,#,#,#,#,#,#,#,#,#,#,#,#,#,#,#,#,#,#,#,#,#,#,#,#,#,#,#,#,#,#,#,#,#,#,#,#,#,#,#,#,#,#,#,
#,#,#,#,#,#,#,#,#,#,#,#,#,#,#,#,#, , ,#,#,#,#,#,#,#,#,#,#,#,#,#,#,#,#, , , , , , , ,#,#,#,#,#,#,#,#,
#,#, , , ,#,#,#,#,#,#,#,#, , , , , , , ,#,#,#,#,#,#,#,#,#,#,#,#,#,#, , , , , , , , , , ,#,#,#,#,#,#,
#, , , , , , ,#,#,#,#,#, , , , , , , , ,#,#,#,#,#,#,#,#,#,#,#,#,#, , , ,#,#,#,#, , , , , ,#,#,#,#,#,
#, , , , , , , , , , , , , ,#,#,#,#, , ,#,#,#,#,#,#,#,#,#,#,#,#,#, , ,#,#,#,#,#,#, , , , ,#,#,#,#,#,
#, , , ,#,#, , , , , , , ,#,#,#,#,#,#, , ,#,#,#,#,#,#, , ,#,#,#, , , ,#,#,#,#,#,#, , , ,#,#,#,#,#,#,
#, , ,#,#,#,#, , , , , , ,#,#,#,#,#,#,#, , ,#,#,#,#, , , , , , , , , , ,#,#,#,#,#, , ,#,#,#,#,#,#,#,
#, , ,#,#,#,#,#, , , , , ,#,#,#,#,#,#,#,#, , ,#,#, , , , , , , , , , , , , ,#,#,#, , ,#,#,#,#,#,#,#,
#, , ,#,#,#,#,#, , , , , , ,#,#,#,#,#,#,#, , , , , , , , , , , , , , , , , , ,#,#, , , ,#,#,#,#,#,#,
#, , ,#,#,#,#, , , , , , , , , ,#,#,#,#, , , , , ,#,#,#,#, , , , , ,#,#,#, , , ,#,#, , , , , , ,#,#,
#, , , ,#,#, , , , , ,#,#, , , , , , , , , , , ,#,#,#,#,#,#, , , ,#,#,#,#,#, , , ,#,#, , , , , , ,#,
#, , , , , , , , , ,#,#,#,#, , , , , , ,#,#, , ,#,#,#,#,#,#, , , ,#,#,#,#,#,#, , ,#,#,#,#,#, , , ,#,
#, , , , , , , , , ,#,#,#,#,#, , , , ,#,#,#,#, , ,#,#,#,#,#, , , ,#,#,#,#,#,#, , ,#,#,#,#,#,#, , ,#,
#,#, , , , , , , , ,#,#,#,#,#,#,#,#,#,#,#,#,#, , ,#,#,#,#, , , , , ,#,#,#,#, , , ,#,#,#,#,#,#, , ,#,
#,#,#,#, , , , , , ,#,#,#,#,#,#,#,#,#,#,#,#,#, , , ,#,#, , , , , , , ,#,#,#, , , ,#,#,#,#,#,#, , ,#,
#,#,#,#,#, , , , ,#,#,#,#,#,#,#,#,#,#,#,#,#,#, , , , , , , ,#,#,#, ,#,#,#,#, , , ,#,#,#,#,#,#, , ,#,
#,#,#,#,#, , , , ,#,#,#,#,#,#,#,#,#,#,#,#,#,#,#, , , , , ,#,#,#,#,#,#,#,#,#, , , ,#,#,#,#,#,#, , ,#,
#,#,#,#,#, , , , ,#,#,#,#,#,#,#,#,#,#,#,#,#,#,#,#, , , ,#,#,#,#,#,#,#,#,#,#,#, , , ,#,#,#,#, , , ,#,
#,#,#,#,#,#, , , , ,#,#,#,#,#,#,#,#,#,#,#,#,#,#,#, , , ,#,#,#,#,#,#,#,#,#,#,#,#, , , ,#,#, , , ,#,#,
#,#,#,#,#,#, , , , , , , ,#,#,#,#,#,#,#,#,#,#,#,#, , , , ,#,#,#,#,#,#,#,#,#,#,#,#, , , , , , ,#,#,#,
#,#,#,#,#, , , ,#,#, , , , ,#,#,#,#,#,#,#,#,#,#,#, , , , , , , , ,#,#,#,#,#,#,#,#,#,#, , ,#,#,#,#,#,
#,#,#,#, , , ,#,#,#,#, , , , ,#,#,#,#,#,#,#,#,#,#,#, , , , , , , ,#,#,#,#,#,#,#,#,#,#,#,#,#,#,#,#,#,
#,#,#, , , , ,#,#,#,#,#, , , ,#,#,#,#,#,#,#,#,#,#,#,#,#,#, , , , ,#,#,#,#,#,#,#,#,#,#,#,#,#,#,#,#,#,
#,#,#, , , , ,#,#,#,#,#, , , ,#,#,#,#,#,#,#,#,#,#,#,#,#,#,#, , , , ,#,#,#,#,#,#,#,#,#,#,#,#,#,#,#,#,
#,#,#,#, , , , ,#,#,#, , , , ,#,#,#,#,#,#,#,#,#,#,#,#,#,#,#, , , , ,#,#,#,#,#,#,#,#,#,#,#,#,#,#,#,#,
#,#,#,#,#, , , , , , , , , ,#,#,#,#,#,#,#,#,#,#,#,#,#,#,#,#,#, , , ,#,#,#,#,#,#,#,#,#,#,#,#,#,#,#,#,
#,#,#,#,#,#,#, , , , , ,#,#,#,#,#,#,#,#,#,#,#, ,#,#,#,#,#,#,#, , ,#,#,#,#,#,#,#,#,#,#,#,#,#,#,#,#,#,
#,#,#,#,#,#,#,#, , , ,#,#,#,#,#,#,#,#,#,#,#, , , ,#,#,#,#,#,#, , ,#,#,#,#,#,#,#,#,#,#,#,#,#,#,#,#,#,
#,#,#,#,#,#,#,#, , , ,#,#,#,#,#,#,#,#,#,#,#,#, , ,#,#,#,#,#, , , ,#,#,#,#,#,#,#,#,#,#,#,#,#,#,#,#,#,
#,#,#,#,#,#,#, , , , ,#,#,#,#,#,#,#,#,#,#,#,#, , , ,#,#,#, , , ,#,#,#,#,#,#,#,#,#,#,#,#,#,#,#,#,#,#,
#,#,#,#,#,#,#, , , , ,#,#,#,#,#,#,#,#,#,#,#,#, , , , , , , , ,#,#,#,#,#,#,#,#,#,#,#,#,#,#,#,#,#,#,#,
#,#,#,#,#,#,#, , , , , ,#,#,#,#,#,#,#,#,#,#, , , , , , , , ,#,#,#,#,#,#,#,#,#,#,#,#,#,#,#,#,#,#,#,#,
#,#,#,#,#,#,#, , , , , ,#,#,#,#,#,#,#,#,#,#, , , , , , , ,#,#,#,#,#,#,#,#,#,#,#,#, , ,#,#,#,#,#,#,#,
#,#,#,#,#,#,#, , , , , , ,#,#,#,#,#,#,#,#,#, , ,#,#,#, , ,#,#,#,#,#,#,#,#,#,#,#, , , , , , ,#,#,#,#,
#,#,#,#,#,#, , , , , , , , ,#,#,#,#,#,#,#,#, , ,#,#,#, , , ,#,#,#,#,#,#, , , , , , , , , , , , ,#,#,
#,#,#,#,#, , , , , , , , , ,#,#,#,#,#,#,#,#,#, , , , , , , ,#,#,#,#,#, , , , , , ,#,#,#,#, , , , ,#,
#,#,#,#, , , ,#,#, , , , , ,#,#,#,#,#,#,#,#,#, , , , , , , , ,#,#,#, , , , , , ,#,#,#,#,#,#, , , ,#,
#,#,#,#, , ,#,#,#,#, , , , , ,#,#,#,#,#,#,#,#, , , , , , , , , , , , , , , , ,#,#,#,#,#,#,#, , ,#,#,
#,#,#, , ,#,#,#,#,#,#, , , , ,#,#,#,#,#,#,#, , , ,#,#, , , , , , , , , , , , ,#,#,#,#,#,#,#, , ,#,#,
#,#, , , ,#,#,#,#,#,#, , , , ,#,#,#,#,#,#, , , ,#,#,#,#, , , , , , , , , , , , ,#,#,#,#,#, , , ,#,#,
#,#, , , ,#,#,#,#,#,#, , , ,#,#,#,#,#,#, , , ,#,#,#,#,#,#, , , , , , , , , , , , ,#,#,#, , , , ,#,#,
#,#, , , , ,#,#,#,#, , , ,#,#,#,#,#,#,#, , ,#,#,#,#,#,#,#,#, , , , , , , , , , , , , , , , , ,#,#,#,
#,#,#, , , , , , , , , ,#,#,#,#,#,#,#,#, , ,#,#,#,#,#,#,#,#,#, , , , ,#,#, , , , , , , , , , ,#,#,#,
#,#,#,#, , , , , , , ,#,#,#,#,#,#,#,#,#,#, ,#,#,#,#,#,#,#,#,#,#,#,#,#,#,#,#, , , , , , , , ,#,#,#,#,
#,#,#,#,#, , ,#,#,#,#,#,#,#,#,#,#,#,#,#,#, , ,#,#,#,#,#,#,#,#,#,#,#,#,#,#,#,#, , ,#,#,#,#,#,#,#,#,#,
#,#,#,#,#,#,#,#,#,#,#,#,#,#,#,#,#,#,#,#,#, , , , ,#,#,#,#,#,#,#,#,#,#,#,#,#,#,#,#,#,#,#,#,#,#,#,#,#,
#,#,#,#,#,#,#,#,#,#,#,#,#,#,#,#,#,#,#,#,#,#, , , ,#,#,#,#,#,#,#,#,#,#,#,#,#,#,#,#,#,#,#,#,#,#,#,#,#,
#,#,#,#,#,#,#,#,#,#,#,#,#,#,#,#,#,#,#,#,#,#,#,#,#,#,#,#,#,#,#,#,#,#,#,#,#,#,#,#,#,#,#,#,#,#,#,#,#,#,
#,#,#,#,#,#,#,#,#,#,#,#,#,#,#,#,#,#,#,#,#,#,#,#,#,#,#,#,#,#,#,#,#,#,#,#,#,#,#,#,#,#,#,#,#,#,#,#,#,#,
#,#,#,#,#,#,#,#,#,#,#,#,#,#,#,#,#,#,#,#,#,#,#,#,#,#,#,#,#,#,#,#,#,#,#,#,#,#,#,#,#,#,#,#,#,#,#,#,#,#,
