#,#,#,#,#,#,#,#,#,#,#,#,#,#,#,#,#,#,#,#,#,#,#,#,#,#,#,#,#,#,#,#,#,#,#,#,#,#,#,#,#,#,#,#,#,#,#,#,#,#,
#,#,#,#, , , , , ,#,#,#,#,#,#,#,#,#,#,#,#,#,#,#,#,#,#,#,#, , , ,#,#,#, , ,#,#,#,#,#,#,#,#,#,#,#,#,#,
#,#,#, , , , , , , , , , , ,#,#,#,#,#,#,#,#,#,#,#,#, , , , , , , , , , , , ,#,#,#,#,#,#,#,#,#,#,#,#,
#,#, , ,#,#,#,#,#,#, , , , , ,#,#,#,#,#, , , , , , , , ,#,#,#,#, , , , , , ,#,#,#,#,#,#,#,#,#,#,#,#,
#, , ,#,#,#,#,#,#,#,#,#, , , , ,#,#,#, , , , , , , , ,#,#,#,#,#,#, , , , , , ,#,#,#,#,#,#,#,#,#,#,#,
#, , ,#,#,#,#,#,#,#,#,#,#, , , , , , , , , , , , , ,#,#,#,#,#,#,#,#, , , , , , ,#,#,#,#,#,#,#,#,#,#,
#, , , ,#,#,#,#,#, , ,#,#,#, , , , , , , , , , , , ,#,#,#,#,#,#,#,#, , , , , , , ,#,#,#,#,#,#,#,#,#,
#,#, , , ,#,#,#, , , , ,#,#,#,#,#,#,#,#, , , , , , , ,#,#,#,#,#,#,#, , , , , , , , , , , , ,#,#,#,#,
#,#,#, , , , , , , , , , ,#,#,#,#,#,#,#,#, , , , , , , ,#,#,#,#,#, , , , , , ,#,#, , , , , , ,#,#,#,
#,#,#,#, , , , , , , , , ,#,#,#,#,#,#,#,#, , , , , , , , , , , , , , , , , ,#,#,#,#,#,#,#, , , ,#,#,
#,#,#,#, , , , , , , , , , ,#,#,#,#,#,#, , , ,#,#,#, , , , , , , , , , , , ,#,#,#,#,#,#,#,#, , ,#,#,
#,#,#, , , , , , , , , , , , ,#,#,#,#, , , ,#,#,#,#,#,#,#,#,#,#,#,#,#,#, , , ,#,#,#,#,#,#,#, , ,#,#,
#,#, , , , , , , , , , ,#,#, , , , , , , , ,#,#,#,#,#,#,#,#,#,#,#,#,#,#,#, , ,#,#,#,#,#,#, , , ,#,#,
#, , , ,#,#,#, , , , ,#,#,#,#, , , , , , , , ,#,#,#,#,#,#,#,#,#,#,#,#,#,#,#, , ,#,#,#,#, , , , ,#,#,
#, , ,#,#,#,#,#, , , ,#,#,#,#,#, , , , , , , , ,#,#,#,#,#,#,#,#,#,#,#,#,#,#, , , , , , , , , ,#,#,#,
#, , ,#,#,#,#,#,#, , ,#,#,#,#,#,#, , , , , , , ,#,#,#,#,#,#,#,#,#,#,#,#,#,#,#, , , , , , , , ,#,#,#,
#, , ,#,#,#,#,#,#, , ,#,#,#,#,#,#,#, , , , , , , ,#,#,#,#,#,#,#,#,#,#,#,#,#,#,#, , , , , , ,#,#,#,#,
#, , ,#,#,#,#,#,#, , ,#,#,#,#,#,#,#,#, , , , , , , ,#,#,#,#,#,#,#,#,#,#,#,#,#,#,#,#,#,#,#,#,#,#,#,#,
#, , , ,#,#,#,#,#, , ,#,#,#,#,#,#,#,#,#, , , , , , , , ,#,#,#,#,#,#,#,#,#,#,#,#,#,#,#,#,#,#,#,#,#,#,
#, , , , ,#,#,#, , ,#,#,#,#,#,#,#,#,#,#,#,#,#,#,#, , , , ,#,#,#,#,#,#,#,#,#,#,#,#,#,#,#,#,#,#,#,#,#,
#,#, , , , , , , , ,#,#,#,#,#,#,#,#,#,#,#,#,#,#,#,#,#, , , ,#,#,#,#,#,#,#,#,#,#,#,#,#,#,#,#,#,#,#,#,
#,#,#,#,#, , , , , ,#,#,#,#,#,#,#,#,#,#,#,#,#,#,#,#,#,#, , , ,#,#,#,#,#,#,#,#,#,#,#,#,#,#,#,#,#,#,#,
#,#,#,#,#,#, , , , ,#,#,#,#,#,#,#,#,#,#,#,#,#,#,#,#,#,#,#, , ,#,#,#,#,#,#,#,#,#,#,#,#,#,#,#,#,#,#,#,
#,#,#,#,#,#, , , , , ,#,#,#,#,#,#,#,#,#,#,#,#,#,#,#,#,#,#,#, , ,#,#,#,#,#,#,#,#,#,#,#,#,#,#,#,#,#,#,
#,#,#,#,#, , , , , , , ,#,#,#,#,#,#,#,#,#,#,#,#,#,#,#,#,#,#, , , , , ,#,#,#,#,#,#,#,#,#,#,#,#,#,#,#,
#,#,#,#,#, , , ,#,#, , , ,#,#,#,#,#,#,#,#,#, , ,#,#,#,#,#,#, , , , , , ,#,#,#,#,#, , , ,#,#,#,#,#,#,
#,#,#,#, , , ,#,#,#,#, , , ,#,#,#,#,#,#,#,#,#, , ,#,#,#,#, , , , , , , , ,#,#,#, , , , , ,#,#,#,#,#,
#,#,#,#, , , ,#,#,#,#,#, , ,#,#,#,#,#,#,#,#,#,#, , , , , , , , , , , , , , , , , , , , , ,#,#,#,#,#,
#,#,#,#, , , ,#,#,#,#,#, , , ,#,#,#,#,#,#,#,#,#,#, , , , , , ,#,#, , , , , , , , , , , , , ,#,#,#,#,
#,#,#,#, , , ,#,#,#,#,#, , , ,#,#,#,#,#,#,#,#,#,#,#,#,#,#,#,#,#,#,#, , , , , ,#,#,#,#,#, , , ,#,#,#,
#,#,#,#, , , , ,#,#,#, , , , , ,#,#,#,#,#,#,#,#,#,#,#,#,#,#,#,#,#,#,#, , , ,#,#,#,#,#,#,#, , , ,#,#,
#,#,#,#, , , , , , , , ,#,#, , ,#,#,#,#,#,#,#,#,#,#,#,#,#,#,#,#,#,#,#,#, , ,#,#,#,#,#,#,#, , , ,#,#,
#,#,#,#,#, , , , , , ,#,#,#,#, , ,#,#,#,#,#,#,#,#,#,#,#,#,#,#,#,#,#,#,#, , , ,#,#,#,#,#,#, , ,#,#,#,
#,#,#,#,#,#,#,#, , ,#,#,#,#,#, , ,#,#,#,#,#,#,#,#,#,#,#,#,#,#,#,#,#,#,#, , , ,#,#,#,#,#, , ,#,#,#,#,
#,#,#,#,#,#,#,#,#, ,#,#,#,#, , , , ,#,#,#,#,#,#,#,#,#,#,#,#,#,#,#,#,#,#, , , , ,#,#, , , ,#,#,#,#,#,
#,#,#,#,#,#,#,#,#, , ,#,#, , , , , ,#,#,#,#,#,#,#,#,#,#,#,#,#,#,#,#,#, , , , , , , , , ,#,#,#,#,#,#,
#,#,#,#,#,#,#,#,#, , , , , , , , ,#,#,#,#,#,#,#,#,#,#,#,#,#,#, , , , , , , , , , , ,#,#,#,#,#,#,#,#,
#,#,#,#,#,#,#,#,#, , , , , , , ,#,#,#,#,#,#,#,#,#,#,#,#,#,#, , , , , , , , , , , ,#,#,#,#,#,#,#,#,#,
#,#,#,#,#,#,#,#, , , , , , , ,#,#,#,#,#,#,#,#,#,#,#,#,#,#,#, , , , , , , , , , ,#,#,#,#,#,#,#,#,#,#,
#,#,#,#,#,#,#, , , ,#,#,#, , ,#,#,#,#,#,#,#,#,#,#,#,#,#,#, , , , ,#,#, , , , , ,#,#,#,#,#,#,#,#,#,#,
#,#,#,#,#,#,#, , ,#,#,#,#,#, , ,#,#,#,#,#,#,#,#,#,#,#,#, , , , ,#,#,#,#, , , ,#,#,#,#,#,#,#,#,#,#,#,
#,#,#,#,#,#,#, , ,#,#,#,#,#, , , ,#,#,#,#,#,#,#,#,#,#,#, , , ,#,#,#,#,#, , ,#,#,#,#, , ,#,#,#,#,#,#,
#,#,#,#,#,#,#, , ,#,#,#,#,#, , , ,#,#,#,#,#,#,#,#,#,#,#, , , ,#,#,#,#,#, , , ,#,#, , , , ,#,#,#,#,#,
#,#,#,#,#,#,#, , ,#,#,#,#,#, , , ,#,#,#,#,#,#,#,#,#,#,#,#, , ,#,#,#,#,#, , , , , , , , ,#,#,#,#,#,#,
#,#,#,#,#,#,#,#, , ,#,#,#, , , ,#,#,#,#,#,#,#,#,#,#,#,#,#, , , ,#,#,#, , , , , , , ,#,#,#,#,#,#,#,#,
#,#,#,#,#,#,#,#, , , , , , , ,#,#,#,#,#,#,#,#,#,#,#,#,#,#, , , , , , , , , , , , ,#,#,#,#,#,#,#,#,#,
#,#,#,#,#,#,#,#,#, , , , ,#,#,#,#,#,#,#,#,#,#,#,#,#,#,#,#,#, , , , , , ,#,#,#,#,#,#,#,#,#,#,#,#,#,#,
#,#,#,#,#,#,#,#,#,#,#,#,#,#,#,#,#,#,#,#,#,#,#,#,#,#,#,#,#,#,#,#, , ,#,#,#,#,#,#,#,#,#,#,#,#,#,#,#,#,
#,#,#,#,#,#,#,#,#,#,#,#,#,#,#,#,#,#,#,#,#,#,#,#,#,#,#,#,#,#,#,#,#,#,#,#,#,#,#,#,#,#,#,#,#,#,#,#,#,#,
#,#,#,#,#,#,#,#,#,#,#,#,#,#,#,#,#,#,#,#,#,#,#,#,#,#,#,#,#,#,#,#,#,#,#,#,#,#,#,#,#,#,#,#,#,#,#,#,#,#,
