#,#,#,#,#,#,#,#,#,#,#,#,#,#,#,#,#,#,#,#,#,#,#,#,#,#,#,#,#,#,#,#,#,#,#,#,#,#,#,#,#,#,#,#,#,#,#,#,#,#,
#,#,#,#,#,#,#,#,#,#,#,#,#,#,#,#,#, , , , ,#,#,#,#,#,#,#,#,#,#,#,#,#,#, , , , , , ,#,#,#,#,#,#,#,#,#,
#,#,#,#,#,#,#,#,#,#,#,#,#,#,#, , , , , , , ,#,#,#,#,#,#,#,#,#,#,#, , , , , , , , , ,#,#,#,#,#,#,#,#,
#,#, , , , , , ,#,#,#,#,#,#, , , , ,#,#, , , ,#,#,#,#,#,#,#,#,#, , , ,#,#,#,#,#, , ,#,#,#,#,#,#,#,#,
#, , , , , , , , ,#,#,#, , , , ,#,#,#,#,#, , , ,#,#,#,#,#,#,#,#, , ,#,#,#,#,#,#,#, ,#,#,#,#,#,#,#,#,
#, , , ,#,#, , , , , , , , , ,#,#,#,#,#,#,#, , , ,#,#,#,#,#,#,#, , ,#,#,#,#,#,#,#, , ,#,#,#,#,#,#,#,
#, , ,#,#,#,#,#, , , , , , ,#,#,#,#,#,#,#,#, , , ,#,#,#,#,#,#,#, , ,#,#,#,#,#,#,#, , ,#,#,#,#,#,#,#,
#, , ,#,#,#,#,#,#, , , , , ,#,#,#,#,#,#,#,#, , , , ,#,#,#,#,#,#, , , ,#,#,#,#,#, , , ,#,#,#,#,#,#,#,
#, , ,#,#,#,#,#,#, , , , , , ,#,#,#,#,#,#,#, , , , ,#,#,#,#,#,#,#, , , , , , , , , , , ,#,#,#,#,#,#,
#, , ,#,#,#,#,#,#, , , , , , , ,#,#,#,#,#,#, , , , ,#,#,#,#,#,#,#,#, , , , , , , , , , ,#,#,#,#,#,#,
#, , , ,#,#,#,#, , , , ,#,#,#, , , ,#,#,#,#,#, , , , ,#,#,#,#,#,#,#,#,#,#, , , , , , , , ,#,#,#,#,#,
#, , , , , , , , , , ,#,#,#,#,#, , , , ,#,#, , , , , ,#,#,#,#,#,#,#,#,#,#,#, , , , , , , , ,#,#,#,#,
#,#, , , , , , , , , ,#,#,#,#,#, , , , , , , , , , , ,#,#,#,#,#,#,#,#,#,#,#, , , , , , , , ,#,#,#,#,
#,#,#,#, , , , , , , , ,#,#,#,#, , , , , , , , , , , ,#,#,#,#,#,#,#,#,#,#, , , , ,#,#, , , , ,#,#,#,
#,#,#,#,#, , , , , , , ,#,#,#,#,#, , , , , , , , , , , ,#,#,#,#,#,#, , , , , , ,#,#,#,#, , , ,#,#,#,
#,#,#,#,#, , , , , , ,#,#,#,#,#,#,#, , ,#,#, , , , , , , ,#,#,#,#, , , , , , , ,#,#,#,#,#, , ,#,#,#,
#,#,#,#,#,#, , , , , ,#,#,#,#,#,#,#,#,#,#,#,#, , , , , , , ,#,#, , , , , , , ,#,#,#,#,#,#, , ,#,#,#,
#,#,#,#,#,#, , , , , ,#,#,#,#,#,#,#,#,#,#,#,#, , , ,#,#, , , , , , , , , , , ,#,#,#,#,#,#, , ,#,#,#,
#,#,#,#,#,#, , , , ,#,#,#,#,#,#,#,#,#,#,#,#, , , ,#,#,#,#,#, , , , , , , , , , ,#,#,#,#,#, , ,#,#,#,
#,#,#,#,#, , , , ,#,#,#,#,#,#,#,#,#,#,#,#, , , , ,#,#,#,#,#,#, , , , , , , , , , , ,#,#, , , ,#,#,#,
#,#,#,#, , , , ,#,#,#,#,#,#,#,#,#,#,#,#,#, , , , ,#,#,#,#,#,#, , , , , , , , , , , , , , , , ,#,#,#,
#,#,#,#, , , ,#,#,#,#,#,#,#, ,#,#,#,#,#,#,#, , , ,#,#,#,#,#, , , , , ,#,#,#, , , , , , , , ,#,#,#,#,
#,#,#,#,#, , ,#,#,#,#,#,#, , , ,#,#,#,#,#,#, , , , ,#,#,#, , , , , ,#,#,#,#,#, , , , , , , ,#,#,#,#,
#,#,#,#,#, , , ,#,#,#,#, , , , ,#,#,#,#,#,#,#, , , , , , , , , , ,#,#,#,#,#,#, , , , , , , ,#,#,#,#,
#,#,#,#,#,#, , , , , , , , , ,#,#,#,#,#,#,#,#, , , , , , ,#,#,#,#,#,#,#,#,#, , , , , , , , ,#,#,#,#,
#,#,#,#,#,#,#,#, , , , , , ,#,#,#,#,#,#,#,#,#,#, , , ,#,#,#,#,#,#,#,#,#,#, , , , , , , , , ,#,#,#,#,
#,#,#,#,#,#,#,#,#,#,#,#,#,#,#,#,#,#,#,#,#,#,#,#,#,#,#,#,#,#,#,#,#,#,#,#,#, , , ,#,#, , , , ,#,#,#,#,
#,#,#,#,#,#,#,#,#,#,#,#,#,#,#,#,#,#,#,#,#,#,#,#,#,#,#,#,#,#,#,#,#,#,#,#,#, , ,#,#,#,#, , , ,#,#,#,#,
#,#,#,#,#,#,#,#,#,#,#,#,#,#,#,#,#,#,#,#,#,#,#,#,#,#,#,#,#,#,#,#,#,#,#,#, , , ,#,#,#,#,#, , ,#,#,#,#,
#,#,#,#,#,#,#,#,#,#,#,#,#,#,#,#,#,#,#,#,#,#,#,#,#,#,#,#,#,#,#,#,#,#,#,#, , ,#,#,#,#,#,#,#, , ,#,#,#,
#,#,#,#,#,#,#,#,#,#,#,#,#,#,#,#,#,#,#,#,#,#,#,#,#,#,#,#,#,#,#,#,#,#,#, , ,#,#,#,#,#,#,#,#, , ,#,#,#,
#,#,#,#,#, , , , ,#,#,#,#,#,#,#,#,#,#,#,#,#,#,#,#,#,#,#,#,#,#,#,#,#,#, , ,#,#,#,#,#,#,#, , , ,#,#,#,
#,#,#,#, , , , , , , , ,#,#,#,#,#,#,#,#,#,#,#,#,#,#,#,#,#,#,#,#,#,#,#, , , ,#,#,#,#,#, , , ,#,#,#,#,
#,#,#, , , , , , , , , , ,#,#,#,#,#,#,#, , ,#,#,#,#,#,#,#,#,#,#,#,#,#, , ,#,#,#,#,#, , , ,#,#,#,#,#,
#,#, , , , , , , , , , , ,#,#,#,#,#,#, , , , ,#,#,#,#,#,#,#,#,#,#,#, , , ,#,#,#,#, , , , ,#,#,#,#,#,
#,#, , ,#,#,#,#, , , , , , ,#,#,#,#, , , , , ,#,#,#,#,#,#,#,#,#,#, , , ,#,#,#,#, , , , ,#,#,#,#,#,#,
#, , ,#,#,#,#,#,#, , , , , , , , , , , , , , , ,#,#,#,#,#,#,#,#,#, , , , ,#,#, , , , , ,#,#,#,#,#,#,
#, , ,#,#,#,#,#,#,#, , , , , , , , , ,#,#,#, , , ,#,#,#,#,#,#,#,#,#, , , , , , , , , , ,#,#,#,#,#,#,
#, , ,#,#,#,#,#,#,#, , , , , , , , ,#,#,#,#,#, , , ,#,#,#,#,#,#,#,#, , , , , , , , , ,#,#,#,#,#,#,#,
#, , ,#,#,#,#,#,#, , , , , , , , ,#,#,#,#,#,#,#, , , , , , , ,#,#, , , ,#,#,#,#, , , ,#,#,#,#,#,#,#,
#,#, , ,#,#,#,#, , , , , , , , , ,#,#,#,#,#,#,#,#, , , , , , , , , , ,#,#,#,#,#,#, , ,#,#,#,#,#,#,#,
#,#, , , , , , , , , , ,#,#,#, , , ,#,#,#,#,#,#,#, , , , , , , , , ,#,#,#,#,#,#,#, , ,#,#,#,#,#,#,#,
#,#, , , , , ,#,#,#,#,#,#,#,#,#, , , , ,#,#,#,#, , , , , , , , , ,#,#,#,#,#,#,#,#, , ,#,#,#,#,#,#,#,
#,#, , , , ,#,#,#,#,#,#,#,#,#,#,#, , , , , , , , , , , , , , , , ,#,#,#,#,#,#,#,#, , ,#,#,#,#,#,#,#,
#,#,#, , ,#,#,#,#,#,#,#,#,#,#,#,#,#,#, , , , , , , , , , , , , , , ,#,#,#,#,#,#, , , ,#,#,#,#,#,#,#,
#,#,#,#,#,#,#,#,#,#,#,#,#,#,#,#,#,#,#,#,#,#,#,#,#, , , , , , , , , , , ,#,#,#, , , ,#,#,#,#,#,#,#,#,
#,#,#,#,#,#,#,#,#,#,#,#,#,#,#,#,#,#,#,#,#,#,#,#,#,#,#,#,#,#, , , , , , , , , , , ,#,#,#,#,#,#,#,#,#,
#,#,#,#,#,#,#,#,#,#,#,#,#,#,#,#,#,#,#,#,#,#,#,#,#,#,#,#,#,#,#, , , , , , , , , ,#,#,#,#,#,#,#,#,#,#,
#,#,#,#,#,#,#,#,#,#,#,#,#,#,#,#,#,#,#,#,#,#,#,#,#,#,#,#,#,#,#,#,#,#,#,#,#,#,#,#,#,#,#,#,#,#,#,#,#,#,
#,#,#,#,#,#,#,#,#,#,#,#,#,#,#,#,#,#,#,#,#,#,#,#,#,#,#,#,#,#,#,#,#,#,#,#,#,#,#,#,#,#,#,#,#,#,#,#,#,#,
