#,#,#,#,#,#,#,#,#,#,#,#,#,#,#,#,#,#,#,#,#,#,#,#,#,#,#,#,#,#,#,#,#,#,#,#,#,#,#,#,#,#,#,#,#,#,#,#,#,#,
#,#,#,#,#, , , , , , ,#,#,#,#,#,#,#,#,#,#,#,#,#,#,#,#,#,#,#,#,#,#,#,#,#,#,#,#,#,#,#,#,#,#,#,#,#,#,#,
#,#,#,#, , , , , , , , , ,#,#,#,#,#,#,#,#,#, , , ,#,#,#,#,#,#,#,#,#,#,#, , , , , ,#,#,#,#,#,#,#,#,#,
#,#,#, , , ,#,#,#,#, , , , ,#,#,#, , , , , , , , , ,#,#,#,#,#,#,#,#, , , , , , , , ,#,#,#,#,#,#,#,#,
#,#,#, , ,#,#,#,#,#,#, , , , , , , , , , , ,#,#, , , ,#,#,#,#,#,#, , , , ,#,#,#, , , ,#,#,#,#,#,#,#,
#,#,#, , ,#,#,#,#,#,#, , , , , , , ,#,#,#,#,#,#,#, , , , , , , , , , , ,#,#,#,#,#, , , ,#,#,#,#,#,#,
#,#,#, , , ,#,#,#,#,#, , , , , , ,#,#,#,#,#,#,#,#,#, , , , , , , , , ,#,#,#,#,#,#,#, , , ,#,#,#,#,#,
#,#,#,#, , ,#,#,#,#, , , , , , , ,#,#,#,#,#,#,#,#,#,#, , , , ,#,#,#,#,#,#,#,#,#,#,#,#, , ,#,#,#,#,#,
#,#,#,#, , , ,#,#, , , , , , , , , ,#,#,#,#,#,#,#,#,#,#,#,#,#,#,#,#,#,#,#,#,#,#,#,#,#, , ,#,#,#,#,#,
#,#,#,#, , , , , , , , , , ,#,#, , , ,#,#,#,#,#,#,#,#,#,#,#, , , , ,#,#,#,#,#,#,#,#, , , ,#,#, ,#,#,
#,#,#,#, , , , , , , , , ,#,#,#,#, , , , , , , , , , , , , , , , , , , , ,#,#,#,#,#, , , , , , , ,#,
#,#,#,#, , , , , , , , ,#,#,#,#,#,#, , , , , , , , , , , , , , , , , , , , ,#,#,#,#, , , , , , ,#,#,
#,#,#,#, , , , , , , ,#,#,#,#,#,#,#, , , , ,#,#,#,#, , , , ,#,#,#,#, , , , , ,#,#,#,#, , , , ,#,#,#,
#,#,#, , , , , , , ,#,#,#,#,#,#,#,#,#, , ,#,#,#,#,#,#,#,#,#,#,#,#,#,#,#, , , ,#,#,#,#, , , , ,#,#,#,
#,#,#, , , ,#,#,#,#,#,#,#,#,#,#,#,#,#,#,#,#,#,#,#,#,#,#,#,#,#,#,#,#,#,#,#, , , ,#,#, , , , ,#,#,#,#,
#,#, , , ,#,#,#,#,#,#,#,#,#,#,#,#,#,#,#,#,#,#,#,#,#,#,#,#,#,#,#,#,#,#,#,#, , , , , , , , ,#,#,#,#,#,
#,#, , ,#,#,#,#,#,#,#,#,#,#,#,#,#,#,#,#,#,#,#,#,#,#,#,#,#,#,#,#,#,#,#,#,#, , , , , , , , ,#,#,#,#,#,
#,#, , ,#,#,#,#,#,#,#,#,#,#,#,#,#,#,#,#,#,#,#,#,#,#,#,#,#,#,#,#,#,#,#,#,#, , , , , , , , ,#,#,#,#,#,
#,#, , , ,#,#,#,#,#,#,#,#,#,#,#,#,#,#,#,#,#,#,#,#,#,#,#,#,#,#,#,#,#,#,#,#, , , , , , , , , ,#,#,#,#,
#,#,#, , , ,#,#,#,#,#, ,#,#,#,#,#,#,#,#,#,#,#,#,#,#,#,#,#,#,#,#,#,#,#,#,#, , , ,#,#,#, , , , ,#,#,#,
#,#,#, , , ,#,#,#,#, , , ,#,#,#,#,#,#, , , , , ,#,#,#,#,#,#,#,#,#,#,#,#, , , ,#,#,#,#,#, , , ,#,#,#,
#,#,#, , , ,#,#,#, , , , ,#,#,#,#,#, , , , , , , , ,#,#,#,#,#,#,#,#,#, , , ,#,#,#,#,#,#,#, , ,#,#,#,
#,#,#, , , , , , , , , , ,#,#,#,#,#, , , , , , , , , , , , ,#,#,#,#,#, , , ,#,#,#,#,#,#,#, , ,#,#,#,
#,#,#, , , , , , , , , ,#,#,#,#,#,#, , , , ,#,#,#,#, , , , , ,#,#,#,#, , , ,#,#,#,#,#,#, , ,#,#,#,#,
#,#,#,#, , , , , , , , ,#,#,#,#,#,#, , , ,#,#,#,#,#,#, , , , ,#,#,#,#,#, , ,#,#,#,#, , , ,#,#,#,#,#,
#,#,#,#, , , , , , , ,#,#,#,#,#,#,#, , , ,#,#,#,#,#,#, , , , ,#,#,#,#,#, , , ,#,#, , , ,#,#,#,#,#,#,
#,#,#,#, , , , , , , ,#,#,#,#,#,#,#, , , ,#,#,#,#,#,#, , , ,#,#,#,#,#,#, , , , , , ,#,#,#,#,#,#,#,#,
#,#,#, , , , , , , , ,#,#,#,#,#,#,#, , , , ,#,#,#,#,#, , , ,#,#,#,#,#,#, , , , , ,#,#,#,#,#,#,#,#,#,
#,#, , , , ,#,#,#, , , ,#,#,#,#,#,#, , , , , ,#,#,#, , , ,#,#,#,#,#,#,#, , , , ,#,#,#,#,#,#,#,#,#,#,
#, , , ,#,#,#,#,#,#, , , ,#,#,#,#,#,#, , , , , , , , , , ,#,#,#,#,#,#,#, , ,#,#,#,#,#,#,#,#,#,#,#,#,
#, , ,#,#,#,#,#,#,#, , , ,#,#,#,#,#,#,#,#, , , , , , , , ,#,#,#,#,#,#,#, ,#,#,#,#,#,#,#,#,#,#,#,#,#,
#, , ,#,#,#,#,#,#, , , , ,#,#,#,#,#,#,#,#,#, , , , , , , ,#,#,#,#,#,#, , ,#,#,#,#,#,#,#,#,#,#,#,#,#,
#,#, , ,#,#,#,#,#, , , , ,#,#,#,#,#,#,#,#,#,#, , ,#, , , ,#,#,#,#,#, , , ,#,#,#,#,#,#,#,#,#,#,#,#,#,
#,#, , ,#,#,#,#,#, , , ,#,#,#,#,#,#,#,#,#,#,#,#,#,#,#, , , ,#,#,#,#, , , ,#,#,#,#,#,#,#,#,#,#,#,#,#,
#,#,#, , ,#,#,#, , , , ,#,#,#,#,#,#,#,#,#,#,#,#,#,#, , , , ,#,#,#,#,#,#,#,#,#,#,#,#,#,#,#,#,#,#,#,#,
#,#,#,#, , , , , , , , ,#,#,#,#,#,#,#,#,#,#,#,#,#, , , , , , ,#,#,#,#,#,#,#,#,#,#, , , , , ,#,#,#,#,
#,#,#,#,#, , , , , , , , ,#,#,#,#,#,#,#,#,#,#,#,#, , , , , , , ,#,#,#,#,#,#,#, , , , , , , , ,#,#,#,
#,#,#,#,#,#, , , , , , , , , ,#,#,#,#,#,#,#,#,#,#, , , ,#,#, , , ,#,#,#,#, , , , , ,#,#,#, , , ,#,#,
#,#,#,#,#,#, , , , , ,#,#, , , ,#,#,#,#,#,#,#,#, , , ,#,#,#,#, , , ,#,#, , , , ,#,#,#,#,#,#, , ,#,#,
#,#,#,#,#,#,#, , , ,#,#,#,#,#, , ,#,#,#,#,#, , , , , ,#,#,#,#,#, , , , , , , ,#,#,#,#,#,#,#, , ,#,#,
#,#,#,#,#,#,#,#,#,#,#,#,#,#,#,#, , ,#,#, , , , , , ,#,#,#,#,#,#,#, , , , , , ,#,#,#,#,#,#,#, , ,#,#,
#,#,#,#,#,#,#,#,#,#,#,#,#,#,#,#, , , , , , , , , ,#,#,#,#,#,#,#,#,#, , , , , ,#,#,#,#,#,#,#, , , ,#,
#,#,#,#,#,#,#,#,#,#,#,#,#,#,#,#, , , , , , , , , ,#,#,#,#,#,#,#,#,#, , , , , , ,#,#,#,#,#, , , , ,#,
#,#,#,#,#,#,#,#,#,#,#,#,#,#,#, , , , , , , , , , , ,#,#,#,#,#,#,#, , , , , , , , , , , , , , , ,#,#,
#,#,#,#,#,#,#,#,#,#,#,#,#,#, , , , , , , , , , , , , , ,#,#,#,#, , , , ,#,#, , , , , , , ,#,#,#,#,#,
#,#,#,#,#,#,#,#,#,#, ,#,#, , , , , , , , , , , , , , , , , , , , , ,#,#,#,#,#, , , ,#,#,#,#,#,#,#,#,
#,#,#,#,#,#,#,#,#, , , , , , , , , , ,#,#,#, , ,#,#,#, , , , ,#,#,#,#,#,#,#,#,#,#,#,#,#,#,#,#,#,#,#,
#,#,#,#,#,#,#,#,#,#, , , , , ,#,#,#,#,#,#,#,#,#,#,#,#,#,#,#,#,#,#,#,#,#,#,#,#,#,#,#,#,#,#,#,#,#,#,#,
#,#,#,#,#,#,#,#,#,#,#, , ,#,#,#,#,#,#,#,#,#,#,#,#,#,#,#,#,#,#,#,#,#,#,#,#,#,#,#,#,#,#,#,#,#,#,#,#,#,
#,#,#,#,#,#,#,#,#,#,#,#,#,#,#,#,#,#,#,#,#,#,#,#,#,#,#,#,#,#,#,#,#,#,#,#,#,#,#,#,#,#,#,#,#,#,#,#,#,#,
