#,#,#,#,#,#,#,#,#,#,#,#,#,#,#,#,#,#,#,#,#,#,#,#,#,#,#,#,#,#,#,#,#,#,#,#,#,#,#,#,#,#,#,#,#,#,#,#,#,#,
#,#,#,#,#,#,#,#,#,#,#,#,#,#,#,#,#,#,#,#,#,#,#,#,#,#,#,#,#,#,#,#,#,#,#,#,#,#,#,#,#,#,#,#,#,#,#,#,#,#,
#,#,#,#, , , , ,#,#,#,#,#,#,#,#,#,#, , , , ,#,#,#,#,#,#,#,#,#,#,#,#,#,#,#,#,#,#,#,#,#,#,#,#,#,#,#,#,
#,#,#, , , , , , ,#,#,#,#,#,#,#, , , , , , , , , ,#,#,#,#,#,#,#,#,#,#,#,#,#,#, , , , , ,#,#,#,#,#,#,
#,#,#, , , , , , , ,#,#,#, , , , , , , ,#,#, , , , ,#,#,#,#,#,#,#,#,#,#,#,#, , , , , , , , , ,#,#,#,
#,#, , , ,#,#,#, , , , , , , , , , , ,#,#,#,#,#, , , ,#,#,#,#,#,#,#,#,#, , , , ,#,#,#, , , , , ,#,#,
#,#, , ,#,#,#,#,#, , , , , , , , , , ,#,#,#,#,#,#, , ,#,#,#,#,#,#,#,#, , , , ,#,#,#,#,#, , , , ,#,#,
#, , ,#,#,#,#,#,#,#, , , , , , , , , ,#,#,#,#,#,#, ,#,#,#,#,#,#,#,#,#, , , , ,#,#,#,#,#, , , , ,#,#,
#,#,#,#,#,#,#,#,#,#, , , , , , , , , ,#,#,#,#,#, , ,#,#,#,#,#,#,#,#,#,#, , , ,#,#,#,#,#, , , , ,#,#,
#,#,#,#,#,#,#,#,#, , , , , , , , , , , ,#,#,#, , , ,#,#,#,#,#,#,#,#,#,#,#, , , ,#,#,#, , , , ,#,#,#,
#,#,#,#,#,#,#,#,#, , , , , , , , , , , , , , , , , , ,#,#,#,#,#,#,#,#,#,#, , , , , , , , ,#,#,#,#,#,
#,#,#,#,#, ,#,#, , , , , , , ,#,#,#,#, , , , , , , , , ,#,#,#,#,#,#,#,#, , , , , , , ,#,#,#,#,#,#,#,
#,#,#,#, , , , , , , , , , ,#,#,#,#,#,#,#,#,#, , , , , , ,#,#,#,#,#,#, , , , , , , ,#,#,#,#,#,#,#,#,
#,#,#,#,#, , , , , , , , ,#,#,#,#,#,#,#,#,#,#,#,#,#,#, , , ,#,#,#,#, , , , , , , , ,#,#,#,#,#,#,#,#,
#,#,#,#,#, , , , , , , ,#,#,#,#,#,#,#,#,#,#,#,#,#,#,#,#, , , , , , , , , , , , , ,#,#,#,#,#,#,#,#,#,
#,#,#,#,#, , , , , , , ,#,#,#,#,#,#,#,#,#,#,#,#,#,#,#,#, , , , , , , , , , , , ,#,#,#,#,#,#,#,#,#,#,
#,#,#,#,#, , , , , , , ,#,#,#,#,#,#,#,#,#,#,#,#,#,#,#, , , ,#,#,#,#, , , , , ,#,#,#,#,#,#,#,#,#,#,#,
#,#,#,#,#, , , , , , , , ,#,#,#,#,#,#,#,#,#,#,#, , , , , ,#,#,#,#,#,#, , , , ,#,#,#,#,#,#,#,#,#,#,#,
#,#,#,#,#, , ,#,#, , , , , ,#,#,#,#,#,#,#,#,#,#, , , , , ,#,#,#,#,#,#, , , , , ,#,#,#,#,#,#,#,#,#,#,
#,#,#,#, , ,#,#,#,#, , , , , ,#,#,#,#,#,#,#,#,#, , , , , ,#,#,#,#,#,#, , , , , ,#,#,#,#,#,#,#,#,#,#,
#,#,#,#, , ,#,#,#,#, , , , , ,#,#,#,#,#,#,#,#,#,#, , , , ,#,#,#,#,#,#, , , , ,#,#,#,#,#,#,#,#,#,#,#,
#,#,#, , , ,#,#,#,#,#, , , , ,#,#,#,#,#,#,#,#,#,#,#, , , , ,#,#,#,#, , , , ,#,#,#,#,#, , ,#,#,#,#,#,
#,#,#, , ,#,#,#,#,#,#, , , ,#,#,#,#,#,#,#,#,#,#,#,#, , , , , , , , , , , , ,#,#,#,#, , , , ,#,#,#,#,
#,#, , , ,#,#,#,#,#,#, , ,#,#,#,#,#,#,#,#,#,#,#,#,#, , , , , , , , , , , , , ,#,#, , , , , ,#,#,#,#,
#,#, , , , ,#,#,#,#, , , ,#,#,#,#,#,#,#,#,#,#,#,#, , , , , , , , , , , , , , , , , , , , , , ,#,#,#,
#,#, , , , , ,#,#, , , , ,#,#,#,#,#,#,#,#,#,#,#, , ,#,#, , , ,#,#, , , , , , , , , , ,#,#, , ,#,#,#,
#,#, , , , , , , , , , ,#,#,#,#,#,#,#,#,#,#,#, , , , ,#, , ,#,#,#,#, , , , ,#,#,#,#,#,#,#,#, , ,#,#,
#,#,#, , , , , , , , ,#,#,#,#,#,#,#,#, , , , , , , , , , , ,#,#,#,#, , , ,#,#,#,#,#,#,#,#,#, , ,#,#,
#,#,#,#,#, , , , , , ,#,#,#,#,#,#, , , , , , , , , , , , ,#,#,#,#,#, , , ,#,#,#,#,#,#,#,#,#, , ,#,#,
#,#,#,#,#,#, , , , ,#,#,#,#,#,#, , , , , ,#,#, , , , ,#,#,#,#,#,#,#, , , ,#,#,#,#,#,#,#,#, , ,#,#,#,
#,#,#,#,#,#,#, , ,#,#,#,#,#,#, , , , , ,#,#,#,#, , ,#,#,#,#,#,#,#,#,#, , ,#,#,#,#,#,#,#,#, , ,#,#,#,
#,#,#,#,#,#,#,#,#,#,#,#,#, , , , , , ,#,#,#,#,#, , ,#,#,#,#,#,#,#,#,#,#, , ,#,#,#,#,#,#,#, , ,#,#,#,
#,#,#,#,#,#,#,#,#,#,#,#, , , , , , ,#,#,#,#,#,#, , , ,#,#,#,#,#,#,#,#,#, , , ,#,#,#,#,#,#, , ,#,#,#,
#,#,#,#,#,#,#,#, , , , , , , , , ,#,#,#,#,#,#,#, , , ,#,#,#,#,#,#,#,#,#,#, , , ,#,#,#,#,#, , ,#,#,#,
#,#,#,#,#,#,#, , , , , , , , , , , ,#,#,#,#,#, , , , ,#,#,#,#,#,#,#,#,#,#,#,#, , ,#,#,#, , ,#,#,#,#,
#,#,#,#,#,#, , , , , , , , , , , , , , , , , , , , ,#,#,#,#,#,#,#,#,#,#,#,#,#,#, , ,#,#, , ,#,#,#,#,
#,#,#,#,#, , , , , , , , , , , , , , , , , , , , , ,#,#,#,#,#,#,#,#,#,#,#,#,#,#, , ,#,#, , ,#,#,#,#,
#,#,#,#, , , ,#,#, , , , , , , , ,#,#,#, , , , , , , ,#,#,#,#,#,#,#,#,#,#,#,#,#, ,#,#,#, , ,#,#,#,#,
#,#,#, , , ,#,#,#,#, , , , , , ,#,#,#,#,#, , , , , , , ,#,#,#,#,#,#,#,#,#,#,#, , ,#,#,#, , ,#,#,#,#,
#,#, , , ,#,#,#,#,#,#, , , , ,#,#,#,#,#,#, , , , , , , ,#,#,#,#,#,#,#,#,#,#, , , ,#,#,#,#, ,#,#,#,#,
#,#, , , ,#,#,#,#,#,#, , , ,#,#,#,#,#,#,#, , , , ,#,#, , ,#,#,#,#, , , , , , , ,#,#,#,#,#, , ,#,#,#,
#,#,#, , ,#,#,#,#,#,#, , ,#,#,#,#,#,#,#,#, , , ,#,#,#,#, , , , , , , , , , , , ,#,#,#,#,#, , ,#,#,#,
#,#,#, , ,#,#,#,#,#, , , ,#,#,#,#,#,#,#,#, , , ,#,#,#,#,#, , , , , , ,#,#, , , ,#,#,#,#,#, , ,#,#,#,
#,#, , , , ,#,#,#,#,#, ,#,#,#,#,#,#,#,#, , , , ,#,#,#,#,#,#, , , ,#,#,#,#,#, , ,#,#,#,#,#, , ,#,#,#,
#,#, , , , ,#,#,#,#,#,#,#,#,#,#,#,#,#,#, , , , ,#,#,#,#,#,#, , ,#,#,#,#,#,#, , , ,#,#,#,#, , ,#,#,#,
#,#,#, , ,#,#,#,#,#,#,#,#,#,#,#,#,#,#,#,#, , , , ,#,#,#,#,#, , ,#,#,#,#,#,#,#, , , ,#,#, , , ,#,#,#,
#,#,#,#,#,#,#,#,#,#,#,#,#,#,#,#,#,#,#,#,#,#,#, , , ,#,#,#, , , ,#,#,#,#,#,#,#,#, , , , , , ,#,#,#,#,
#,#,#,#,#,#,#,#,#,#,#,#,#,#,#,#,#,#,#,#,#,#,#,#, , , , , , , ,#,#,#,#,#,#,#,#,#,#,#, , , ,#,#,#,#,#,
#,#,#,#,#,#,#,#,#,#,#,#,#,#,#,#,#,#,#,#,#,#,#,#,#,#, , , ,#,#,#,#,#,#,#,#,#,#,#,#,#,#,#,#,#,#,#,#,#,
#,#,#,#,#,#,#,#,#,#,#,#,#,#,#,#,#,#,#,#,#,#,#,#,#,#,#,#,#,#,#,#,#,#,#,#,#,#,#,#,#,#,#,#,#,#,#,#,#,#,
