#,#,#,#,#,#,#,#,#,#,#,#,#,#,#,#,#,#,#,#,#,#,#,#,#,#,#,#,#,#,#,#,#,#,#,#,#,#,#,#,#,#,#,#,#,#,#,#,#,#,
#,#,#,#,#,#,#,#, , , , ,#,#,#,#,#,#,#,#,#,#,#,#,#,#,#,#,#,#,#,#,#,#,#,#,#,#, , , , , , ,#,#,#,#,#,#,
#,#,#,#,#,#, , , , , , , , , ,#,#,#,#,#,#,#,#,#,#,#,#,#,#,#,#,#,#,#,#, , , , , , , , , , ,#,#,#,#,#,
#,#,#,#,#, , , , , , , , , , , , ,#,#,#,#,#,#,#,#,#,#,#,#,#,#,#,#,#, , , , ,#,#,#, , , , ,#,#,#,#,#,
#,#,#,#,#, , , , , , , , , , , , , ,#,#,#,#,#,#,#,#,#,#,#,#,#,#,#,#, , , ,#,#,#,#,#, , ,#,#,#,#,#,#,
#,#,#,#,#,#, , , , ,#,#,#,#, , , , ,#,#,#,#,#,#,#,#,#,#,#,#,#,#,#,#, , , ,#,#,#,#,#, , ,#,#,#,#,#,#,
#,#,#,#,#,#, , , ,#,#,#,#,#,#, , , ,#,#,#,#,#,#,#,#,#,#,#,#,#,#,#, , , , ,#,#,#,#,#, , , ,#,#,#,#,#,
#,#,#,#,#,#, , ,#,#,#,#,#,#,#, , ,#,#,#,#,#,#,#,#,#,#,#,#,#,#,#, , , , , , ,#,#,#, , , , ,#,#,#,#,#,
#,#,#,#,#,#, , ,#,#,#,#,#,#, , , ,#,#,#,#,#,#,#,#,#,#,#,#,#,#,#, , , , , , , , , , , , , ,#,#,#,#,#,
#,#,#,#,#,#,#, , ,#,#,#,#, , , ,#,#,#,#,#,#,#,#,#,#,#,#,#,#,#, , , , , , , , , , , , , ,#,#,#,#,#,#,
#,#,#,#,#,#,#, , , ,#,#, , , ,#,#,#,#,#,#,#,#,#, , , , , , , , , , , , , , , ,#,#,#,#,#,#,#,#,#,#,#,
#,#,#,#,#,#,#, , , , , , , , ,#,#,#,#,#,#,#,#, , , , , , , , , , , , , , , ,#,#,#,#,#,#,#,#,#,#,#,#,
#,#,#,#,#,#,#, , , , , , , , ,#,#,#,#,#,#,#,#, , , , , ,#,#,#,#,#,#,#,#,#,#,#,#,#,#,#,#,#,#,#,#,#,#,
#,#,#,#,#,#,#, , , , , , , ,#,#,#,#,#,#,#,#,#,#, , , ,#,#,#,#,#,#,#,#,#,#,#,#,#,#,#,#,#,#,#,#,#,#,#,
#,#,#,#,#,#,#,#, , , , , ,#,#,#,#,#,#,#,#,#,#,#, , , ,#,#,#,#,#,#,#,#,#,#,#,#,#,#,#,#,#,#,#,#,#,#,#,
#,#,#,#,#,#,#,#, , , , ,#,#,#,#,#,#,#,#,#,#,#,#,#, , ,#,#,#,#,#,#,#,#,#,#,#,#,#,#,#,#,#,#,#,#,#,#,#,
#,#,#,#,#,#,#,#, , , , ,#,#,#,#,#,#,#,#,#,#,#,#,#, , , ,#,#,#,#,#,#,#,#,#,#,#,#,#,#,#,#,#,#,#,#,#,#,
#,#,#,#,#,#,#, , , , ,#,#,#,#,#,#,#,#,#,#,#,#,#,#, , , ,#,#,#,#,#,#, , ,#,#,#,#,#,#,#,#,#,#,#,#,#,#,
#,#,#,#,#,#, , , , , ,#,#,#,#,#,#,#,#,#,#,#,#,#, , , , , ,#,#,#,#, , , , , , , ,#,#,#,#,#,#,#,#,#,#,
#,#,#,#, , , , , , , ,#,#,#,#,#,#,#,#,#,#,#,#, , , , , , ,#,#,#,#, , , , , , , , , , , ,#,#,#,#,#,#,
#,#,#, , , ,#,#, , , ,#,#,#,#,#,#,#,#,#, , , , , , , , , ,#,#,#,#, , , , , , , , , , , , ,#,#,#,#,#,
#,#, , , ,#,#,#,#, , , ,#,#,#,#,#,#,#, , , , , , , , , ,#,#,#,#,#,#, , , , , , , , , , , , ,#,#,#,#,
#,#, , ,#,#,#,#,#,#, , , , ,#,#,#,#, , , , ,#,#, , , , ,#,#,#,#,#,#,#, , , , , ,#,#,#,#, , , ,#,#,#,
#,#, , ,#,#,#,#,#,#, , , , , , , , , , ,#,#,#,#,#, , ,#,#,#,#,#,#,#,#, , , , ,#,#,#,#,#,#, , ,#,#,#,
#,#, , ,#,#,#,#,#, , , , , , , , , ,#,#,#,#,#,#,#, , ,#,#,#,#,#,#,#,#, , , , ,#,#,#,#,#,#, , ,#,#,#,
#,#, , , ,#,#, , , , , , , , , , ,#,#,#,#,#,#,#, , , ,#,#,#,#,#,#,#,#, , , , ,#,#,#,#,#, , ,#,#,#,#,
#,#,#, , , , , , ,#,#,#, , , , , ,#,#,#,#,#,#,#, , , , ,#,#,#,#,#,#,#,#, , , , ,#,#,#, , ,#,#,#,#,#,
#,#,#,#, , , , ,#,#,#,#,#, , , , ,#,#,#,#,#,#, , , , , , ,#,#,#,#,#,#,#, , , , , , , , , ,#,#,#,#,#,
#,#,#,#,#, , ,#,#,#,#,#,#,#, , , , ,#,#,#,#, , , , , , ,#,#,#,#,#,#,#,#, , , , , , , , ,#,#,#,#,#,#,
#,#,#,#,#,#,#,#,#,#,#,#,#,#,#, , , , , , , , , , , , ,#,#,#,#,#,#,#,#,#,#, , , , , ,#,#,#,#,#,#,#,#,
#,#,#,#,#,#,#,#,#,#,#,#,#,#,#, , , , , , , , , , , ,#,#,#,#,#,#,#,#,#,#,#,#,#,#, , ,#,#,#,#,#,#,#,#,
#,#,#,#,#,#,#,#,#,#,#,#,#,#,#, , , , , , , , , , ,#,#,#,#,#,#,#,#,#,#,#,#,#,#,#, , , ,#,#,#,#,#,#,#,
#,#,#,#,#,#,#,#,#,#,#,#,#,#, , , , , , , , , , , ,#,#,#,#,#,#,#,#,#,#,#,#,#,#,#,#, , ,#,#,#,#,#,#,#,
#,#,#,#,#,#,#,#,#,#,#,#,#, , , , , , , , , , , ,#,#,#,#,#,#,#,#,#,#,#,#,#,#,#,#,#, , , ,#,#,#,#,#,#,
#,#,#,#,#,#,#,#,#,#,#,#,#, , , , , , , , ,#,#,#,#,#,#,#,#,#,#,#,#,#,#,#,#,#,#, , , , , , ,#,#,#,#,#,
#,#,#,#,#,#, , ,#,#,#,#, , , , , , , , ,#,#,#,#,#,#,#,#,#,#,#,#,#,#,#,#,#,#, , , , , , ,#,#,#,#,#,#,
#,#,#, , , , , , , , , , , , , , , , , ,#,#,#,#,#,#,#,#,#, , ,#,#,#,#,#,#, , , , , , , ,#,#,#,#,#,#,
#,#, , , , , , , , , , , , , ,#,#, , , ,#,#,#,#,#,#, , , , , , ,#,#,#,#,#, , , , , , , , ,#,#,#,#,#,
#, , , ,#,#,#,#,#, , ,#,#,#,#,#,#,#, , , ,#,#,#, , , , , , , , ,#,#,#,#, , , ,#,#,#,#, , ,#,#,#,#,#,
#, , ,#,#,#,#,#,#,#,#,#,#,#,#,#,#,#,#, , , , , , , ,#,#,#,#, , , ,#,#, , , ,#,#,#,#,#,#, , ,#,#,#,#,
#, , ,#,#,#,#,#,#,#,#,#,#,#,#,#,#,#,#, , , , , , ,#,#,#,#,#,#, , , , , , , ,#,#,#,#,#,#,#, , ,#,#,#,
#, , ,#,#,#,#,#,#,#,#,#,#,#,#,#,#,#,#, , , , , , ,#,#,#,#,#,#, , , , , , , ,#,#,#,#,#,#,#, , ,#,#,#,
#, , , ,#,#,#, , , , , , ,#,#,#,#,#, , , , , , , ,#,#,#,#,#,#, , , , , , , ,#,#,#,#,#,#, , , ,#,#,#,
#, , , , , , , , , , , , , , , , , , , , , , , , , ,#,#,#,#, , , , , , , , , ,#,#,#,#,#, , , ,#,#,#,
#, , , , , , , , , ,#,#,#, , , , , ,#,#,#,#, , , , , , , , , , , , , , , , , , ,#,#,#, , , ,#,#,#,#,
#, , , , ,#,#,#,#,#,#,#,#,#,#, , ,#,#,#,#,#,#, , , , , , , , , , , , , , , , , , , , , , , ,#,#,#,#,
#,#, , ,#,#,#,#,#,#,#,#,#,#,#,#,#,#,#,#,#,#,#,#,#,#,#,#, , ,#,#, , ,#,#,#,#, , , , , , , ,#,#,#,#,#,
#,#,#,#,#,#,#,#,#,#,#,#,#,#,#,#,#,#,#,#,#,#,#,#,#,#,#,#,#,#,#,#,#,#,#,#,#,#,#, , , ,#,#,#,#,#,#,#,#,
#,#,#,#,#,#,#,#,#,#,#,#,#,#,#,#,#,#,#,#,#,#,#,#,#,#,#,#,#,#,#,#,#,#,#,#,#,#,#,#,#,#,#,#,#,#,#,#,#,#,
#,#,#,#,#,#,#,#,#,#,#,#,#,#,#,#,#,#,#,#,#,#,#,#,#,#,#,#,#,#,#,#,#,#,#,#,#,#,#,#,#,#,#,#,#,#,#,#,#,#,
