#,#,#,#,#,#,#,#,#,#,#,#,#,#,#,#,#,#,#,#,#,#,#,#,#,#,#,#,#,#,#,#,#,#,#,#,#,#,#,#,#,#,#,#,#,#,#,#,#,#,
#,#,#,#, , , , ,#,#,#,#,#,#,#,#,#,#,#,#,#,#,#,#,#,#,#,#,#,#,#,#, , , , , , , , , ,#,#,#,#,#,#,#,#,#,
#,#,#, , , , , , ,#,#,#,#,#,#,#,#,#,#,#,#,#,#,#,#,#,#,#,#,#,#, , , , , , , , , , , ,#,#,#,#,#,#,#,#,
#,#,#, , , , , ,#,#,#,#,#,#,#,#,#,#,#,#,#,#,#,#,#,#,#,#,#,#,#, , , , ,#,#,#, , , , , ,#,#,#,#,#,#,#,
#,#,#,#, , , ,#,#,#,#,#,#,#,#,#,#,#,#,#,#,#,#,#,#,#,#,#,#,#, , , , ,#,#,#,#,#, , , , ,#,#,#,#,#,#,#,
#,#,#,#, , , ,#,#,#,#,#,#,#,#,#,#,#,#,#,#,#,#,#,#, , , , , , , , , ,#,#,#,#,#, , , , ,#,#,#,#,#,#,#,
#,#,#,#, , , ,#,#,#,#,#,#,#,#,#,#,#,#,#,#,#,#,#, , , , , , , , , , , ,#,#,#,#, , , , , ,#,#,#,#,#,#,
#,#,#,#, , , ,#,#,#,#,#,#,#,#,#,#,#,#,#,#,#,#, , , , , , , , , , , , , ,#,#,#,#, , , , , ,#,#,#,#,#,
#,#,#,#,#, , , ,#,#,#, , ,#,#,#,#,#,#,#, , , , , , , , , , , , , , , , , ,#,#,#,#, , , , , ,#,#,#,#,
#,#,#,#,#,#, , ,#,#, , , , , , ,#,#,#, , , , , , , , , , , , , , ,#,#,#, , ,#,#,#,#,#, , , , ,#,#,#,
#,#,#,#,#,#, , ,#,#,#, , , , , , , , , , , ,#,#,#,#,#, , , , , ,#,#,#,#,#, , ,#,#,#,#,#, , , , ,#,#,
#,#,#,#,#,#, , ,#,#,#, , , , , , , , , , ,#,#,#,#,#,#,#, , , ,#,#,#,#,#,#, , , ,#,#,#,#,#, , , ,#,#,
#,#,#,#,#, , , ,#,#,#,#, , , , , , , , , ,#,#,#,#,#,#,#, , , ,#,#,#,#,#,#, , , ,#,#,#,#,#, , , ,#,#,
#,#,#,#, , , ,#,#,#,#,#,#, , , , , , , , ,#,#,#,#,#,#,#, , ,#,#,#,#,#,#,#, , , ,#,#,#,#,#, , ,#,#,#,
#,#,#,#, , , ,#,#,#,#,#,#, , , , , , , , , ,#,#,#,#,#,#, , ,#,#,#,#,#,#, , , , ,#,#,#,#,#, , ,#,#,#,
#,#,#,#, , , ,#,#,#,#,#,#, , , , , , , , , , ,#,#,#,#, , , ,#,#,#,#,#,#, , , , ,#,#,#,#,#, , , ,#,#,
#,#,#,#,#, , ,#,#,#,#,#, , , , ,#,#,#,#,#, , , , , , , , , , ,#,#,#,#,#,#, , , ,#,#,#,#,#, , , ,#,#,
#,#,#,#,#,#, ,#,#,#,#, , , ,#,#,#,#,#,#,#,#, , , , ,#,#,#, , , , ,#,#,#,#,#, , ,#,#,#,#,#, , , ,#,#,
#,#,#,#,#,#, , ,#,#, , , ,#,#,#,#,#,#,#,#,#,#, , ,#,#,#,#,#, , , , ,#,#,#,#,#, , ,#,#,#,#, , ,#,#,#,
#,#,#,#,#,#, , , , , , , ,#,#,#,#,#,#,#,#,#,#,#,#,#,#,#,#,#, , , , , ,#,#,#,#, , , ,#,#, , , ,#,#,#,
#,#,#,#,#,#,#, , , , , , , ,#,#,#,#,#,#,#,#,#,#,#,#,#,#,#,#,#, , , , ,#,#,#,#, , , , , , , ,#,#,#,#,
#,#,#,#,#,#,#, , , , , , , ,#,#,#,#,#,#,#,#,#,#,#,#,#,#,#,#,#, , , , ,#,#,#,#, , , , , , ,#,#,#,#,#,
#,#,#,#,#,#, , , , , , , ,#,#,#,#,#,#,#,#,#,#,#,#,#,#,#,#,#,#,#, , ,#,#,#,#,#, , , , , ,#,#,#,#,#,#,
#,#,#,#, , , , , , , , ,#,#,#,#,#, , , , , , , , , , ,#,#,#,#,#,#,#,#,#,#,#, , , , , , ,#,#,#,#,#,#,
#,#,#, , , , , , , , ,#,#,#,#,#, , , , , , , , , , , ,#,#,#,#,#,#,#,#,#,#, , , ,#,#, , , ,#,#,#,#,#,
#,#,#, , , , , , , , ,#,#,#,#, , , , , , , , , , , , ,#,#,#,#,#,#,#,#,#, , , ,#,#,#,#, , ,#,#,#,#,#,
#,#, , , ,#,#,#, , , , ,#,#, , , , , , , ,#,#, , , , , ,#,#,#,#,#,#,#, , , , ,#,#,#,#,#, , ,#,#,#,#,
#,#, , ,#,#,#,#,#, , , , , , , , , , ,#,#,#,#,#, , , , , ,#,#,#,#,#,#, , , ,#,#,#,#,#,#, , ,#,#,#,#,
#, , , ,#,#,#,#,#, , , , , , , , , ,#,#,#,#,#,#,#,#, , , ,#,#,#,#,#,#, , , ,#,#,#,#,#,#, , ,#,#,#,#,
#, , , ,#,#,#,#,#, , , , , , , , , ,#,#,#,#,#,#,#,#,#,#,#,#,#,#,#,#,#, , , ,#,#,#,#,#, , ,#,#,#,#,#,
#,#, , , ,#,#,#,#, , , , , , , , , , ,#,#,#,#,#,#,#,#,#,#,#,#,#,#,#, , , , , ,#,#,#, , , ,#,#,#,#,#,
#,#,#, , , ,#,#, , , , , , , , , , , , ,#,#,#,#,#,#,#,#,#,#,#,#,#, , , , , , , , , , , ,#,#,#,#,#,#,
#,#,#,#, , , , , , , , , ,#,#,#, , , , , , ,#,#,#,#,#,#,#,#,#,#, , , , , , , , , , , ,#,#,#,#,#,#,#,
#,#,#,#,#, , , , , , , ,#,#,#,#,#,#, , , , ,#,#,#,#,#,#,#,#,#,#, , , , , , , , , , , ,#,#,#,#,#,#,#,
#,#,#,#,#,#, , , , , , ,#,#,#,#,#,#,#, , , ,#,#,#,#,#,#,#,#,#,#, , , , , , , , , , , , ,#,#,#,#,#,#,
#,#,#,#,#,#,#, , , , , ,#,#,#,#,#,#,#,#,#,#,#,#,#,#,#,#,#,#,#,#, , , , , , , , , , , , , ,#,#,#,#,#,
#,#,#,#,#,#,#, , , , ,#,#,#,#,#,#,#,#,#,#,#,#,#,#,#,#,#,#,#,#,#, , , , , , ,#,#, , , , , ,#,#,#,#,#,
#,#,#,#,#,#,#,#, , , ,#,#,#,#,#,#,#,#,#,#,#,#,#,#,#,#,#,#,#,#,#, , , , , ,#,#,#,#, , , , ,#,#,#,#,#,
#,#,#,#,#,#,#,#, , , , ,#,#,#,#,#,#,#,#,#,#,#,#,#,#,#,#,#,#,#,#,#, , , ,#,#,#,#,#, , , , ,#,#,#,#,#,
#,#,#,#,#,#,#,#, , , , , , ,#,#,#,#,#,#,#,#,#,#,#,#,#,#,#,#,#,#,#, , , ,#,#,#,#,#, , , , ,#,#,#,#,#,
#,#,#,#,#,#,#,#, , ,#,#, , , ,#,#,#,#,#,#,#,#,#,#,#,#,#,#,#,#,#,#, , ,#,#,#,#,#,#, , , , ,#,#,#,#,#,
#,#,#,#,#,#,#, , ,#,#,#,#, , , ,#,#,#,#,#,#,#,#,#,#,#,#,#,#,#,#,#, , ,#,#,#,#,#,#, , , , ,#,#,#,#,#,
#,#,#,#,#,#,#, , ,#,#,#,#,#, , , ,#,#,#,#,#,#,#,#,#,#,#,#,#,#,#,#, , ,#,#,#,#,#,#, , , , ,#,#,#,#,#,
#,#,#,#,#,#,#, , ,#,#,#,#,#, , , , ,#,#,#,#,#,#,#,#,#,#,#,#,#,#,#, , , ,#,#,#,#, , , , , ,#,#,#,#,#,
#,#,#,#,#,#,#, , ,#,#,#,#,#, , , , ,#,#,#,#,#,#,#,#,#,#,#,#,#,#,#,#, , , , , , , , , , , ,#,#,#,#,#,
#,#,#,#,#,#,#, , , ,#,#,#, , , , ,#,#,#,#,#,#,#,#,#,#,#,#,#,#,#,#,#,#, , , , , , , , , ,#,#,#,#,#,#,
#,#,#,#,#,#,#,#, , , , , , , , ,#,#,#,#,#,#,#,#,#,#,#,#,#,#,#,#,#,#,#,#,#,#,#,#,#,#,#,#,#,#,#,#,#,#,
#,#,#,#,#,#,#,#,#, , , , , , ,#,#,#,#,#,#,#,#,#,#,#,#,#,#,#,#,#,#,#,#,#,#,#,#,#,#,#,#,#,#,#,#,#,#,#,
#,#,#,#,#,#,#,#,#,#,#, , , ,#,#,#,#,#,#,#,#,#,#,#,#,#,#,#,#,#,#,#,#,#,#,#,#,#,#,#,#,#,#,#,#,#,#,#,#,
#,#,#,#,#,#,#,#,#,#,#,#,#,#,#,#,#,#,#,#,#,#,#,#,#,#,#,#,#,#,#,#,#,#,#,#,#,#,#,#,#,#,#,#,#,#,#,#,#,#,
