#,#,#,#,#,#,#,#,#,#,#,#,#,#,#,#,#,#,#,#,#,#,#,#,#,#,#,#,#,#,#,#,#,#,#,#,#,#,#,#,#,#,#,#,#,#,#,#,#,#,
#,#,#,#,#,#,#,#,#,#,#,#,#,#,#,#,#,#,#,#, , , ,#,#,#,#,#,#,#,#,#,#,#,#,#,#,#,#,#,#,#,#,#,#,#,#,#,#,#,
#,#,#, , , , , ,#,#,#,#,#,#,#,#,#,#,#, , , , , , , , , ,#,#,#,#,#,#,#,#,#,#,#,#,#,#,#,#,#,#,#,#,#,#,
#,#, , , , , , , ,#,#,#,#,#,#,#,#,#, , ,#,#,#, , , , , , ,#,#,#,#,#,#,#,#,#,#, , , , , , ,#,#,#,#,#,
#, , , ,#,#,#, , ,#,#,#,#,#,#,#,#, , ,#,#,#,#,#, , , , , ,#,#,#,#,#,#,#,#,#, , , , , , , , ,#,#,#,#,
#, , ,#,#,#,#,#, , ,#,#,#,#,#,#,#, , ,#,#,#,#,#, , , , , ,#,#,#,#,#,#,#,#,#, , , ,#,#,#,#, , ,#,#,#,
#, , ,#,#,#,#,#, , ,#,#,#,#,#,#,#, , ,#,#,#,#,#, , , , , ,#,#,#,#,#,#,#,#, , , ,#,#,#,#,#,#, , ,#,#,
#, , ,#,#,#,#,#, , ,#,#,#,#,#,#,#, , ,#,#,#,#, , , , , , , ,#,#,#,#,#,#, , , ,#,#,#,#,#,#,#, , ,#,#,
#, , ,#,#,#,#,#,#, ,#,#,#,#,#,#,#, , , ,#,#, , , , , , , , , , ,#,#,#, , , , ,#,#,#,#,#,#,#, , ,#,#,
#, , , ,#,#,#,#,#, , ,#,#,#,#,#,#, , , , , , , , , ,#,#,#, , , , ,#, , , , , ,#,#,#,#,#,#,#, , ,#,#,
#, , , , , ,#,#, , , ,#,#,#,#,#,#, , , , , , ,#,#,#,#,#,#,#,#, , , , , , , ,#,#,#,#,#,#,#, , , ,#,#,
#,#, , , , , , , , , , ,#,#,#,#, , , , , , ,#,#,#,#,#,#,#,#,#, , , , , , ,#,#,#,#,#, , , , , ,#,#,#,
#,#,#,#, , , , , , , , , , , , , , , , , , ,#,#,#,#,#,#,#,#,#, , , , , ,#,#,#,#,#, , , ,#,#,#,#,#,#,
#,#,#,#,#,#, , , , , , , , , , , , , , , , ,#,#,#,#,#,#,#,#,#, , , ,#,#,#,#,#,#, , , ,#,#,#,#,#,#,#,
#,#,#,#,#,#,#, , , , , ,#,#,#, , , , , , ,#,#,#,#,#,#,#,#,#,#, , ,#,#,#,#,#,#,#, , , ,#,#,#,#,#,#,#,
#,#,#,#,#,#,#,#, , , ,#,#,#,#,#,#,#, , , ,#,#,#,#,#,#,#,#,#, , , ,#,#,#,#,#,#,#, , ,#,#,#,#,#,#,#,#,
#,#,#,#,#,#,#,#, , , ,#,#,#,#,#,#,#,#, ,#,#,#,#,#,#,#,#,#,#, , , ,#,#,#,#,#,#,#, , ,#,#,#,#,#,#,#,#,
#, , , ,#,#,#,#, , , , ,#,#,#,#,#,#,#,#,#,#,#,#,#,#,#,#,#,#,#, , ,#,#,#,#,#,#,#, , ,#,#,#,#,#,#,#,#,
#, , , , ,#,#, , , , , ,#,#,#,#,#,#,#,#,#,#,#,#,#,#,#,#,#,#,#,#, ,#,#,#,#,#,#, , , ,#,#,#,#,#,#,#,#,
#,#, , , , , , , , , , ,#,#,#,#,#,#,#,#,#,#,#,#,#,#,#,#,#,#,#,#, , ,#,#,#,#, , , ,#,#,#,#,#,#,#,#,#,
#,#, , , , , , , , , ,#,#,#,#,#,#,#,#,#,#,#,#,#,#,#,#,#,#,#,#, , , , , , , , , ,#,#,#,#,#,#,#,#,#,#,
#,#, , , , , , , , ,#,#,#,#,#,#,#,#,#,#,#,#,#,#,#,#,#,#,#, , , , , , , , , , ,#,#,#,#,#,#,#,#,#,#,#,
#, , , ,#,#,#,#,#,#,#,#,#,#,#,#,#,#,#,#,#,#,#,#,#,#,#,#, , , , , , , , , ,#,#,#,#,#,#,#,#,#,#,#,#,#,
#, , ,#,#,#,#,#,#,#,#,#,#,#,#, , , , , , , ,#,#,#,#,#,#,#, , , , , ,#,#,#,#,#,#,#,#,#,#,#,#,#,#,#,#,
#, , ,#,#,#,#,#,#,#,#,#,#, , , , , , , , , , ,#,#,#,#,#,#,#, , , ,#,#,#,#,#,#,#,#,#,#,#,#,#,#,#,#,#,
#, , ,#,#,#,#,#,#,#,#,#, , , , ,#,#,#,#, , , ,#,#,#,#,#,#,#, , , ,#,#,#,#,#,#,#,#,#,#,#,#,#,#,#,#,#,
#, , ,#,#,#,#,#,#,#,#,#, , , ,#,#,#,#,#,#, , ,#,#,#,#,#,#,#, , ,#,#,#,#,#,#,#,#,#,#,#,#,#,#,#,#,#,#,
#, , , ,#,#, ,#,#,#,#,#,#, , ,#,#,#,#,#,#,#, , ,#,#,#,#,#, , ,#,#,#,#,#,#,#,#,#,#,#,#,#,#,#,#,#,#,#,
#, , , , , , , ,#,#,#,#,#, , ,#,#,#,#,#,#,#, , , ,#,#,#,#, , ,#,#,#,#,#,#,#,#,#,#,#,#,#,#,#,#,#,#,#,
#, , , , , , , ,#,#,#,#,#, , ,#,#,#,#,#,#,#,#, , , ,#,#, , , ,#,#,#,#,#,#,#,#,#,#,#,#,#,#,#,#,#,#,#,
#,#, , , , , , ,#,#,#,#,#, , ,#,#,#,#,#,#,#,#,#, , , , , , , ,#,#,#,#,#,#,#,#,#,#,#,#,#,#,#,#,#,#,#,
#,#, , , , , , ,#,#,#,#,#,#,#,#,#,#,#,#,#,#,#,#, , , , , , , ,#,#,#,#,#,#,#,#,#,#,#,#, , ,#,#,#,#,#,
#,#,#, , , , , , ,#,#,#,#,#,#,#,#,#,#,#,#,#,#,#,#, , , , , ,#,#,#,#,#,#,#,#,#, , , , , , , ,#,#,#,#,
#,#,#, , , , , , , ,#,#,#,#,#,#,#,#,#,#,#,#,#,#,#, , , , , ,#,#,#,#,#,#,#,#, , , , , , , , ,#,#,#,#,
#,#,#,#, , , , , , , ,#,#,#,#,#,#,#, , , ,#,#,#, , , , , , ,#,#,#,#,#,#,#, , , ,#,#,#,#, , , ,#,#,#,
#,#,#,#, , , ,#,#, ,#,#,#,#,#,#,#,#, , , , , , , , , , , , ,#,#,#,#,#,#, , , ,#,#,#,#,#,#, , ,#,#,#,
#,#,#,#, , ,#,#,#,#,#,#,#,#,#,#,#,#,#, , , , , , , , , , , , ,#,#,#,#, , , ,#,#,#,#,#,#,#, , , ,#,#,
#,#,#,#, , ,#,#,#,#,#,#,#,#,#,#,#,#,#,#,#,#,#, , , ,#,#,#, , , ,#,#, , , , ,#,#,#,#,#,#,#, , , ,#,#,
#,#,#,#, , ,#,#,#,#,#,#,#,#,#,#,#,#,#,#,#,#,#,#,#,#,#,#,#,#, , , , , , , , , ,#,#,#,#,#, , , ,#,#,#,
#,#,#, , , ,#,#,#,#,#,#,#,#,#,#,#,#,#,#,#,#,#,#,#,#,#,#,#,#,#, , , , , , , , , , , , , , , ,#,#,#,#,
#,#,#, , , ,#,#,#,#,#,#,#,#,#,#,#,#,#,#,#,#,#,#,#,#,#,#,#,#,#,#, , , , , , , , , , , , , ,#,#,#,#,#,
#,#,#,#, , , ,#,#,#,#,#, , , ,#,#,#,#,#,#,#,#,#,#,#,#,#,#,#,#,#, , , , , , , , , , , , ,#,#,#,#,#,#,
#,#,#,#,#, , ,#,#,#,#,#, , , ,#,#,#,#,#,#,#,#,#,#,#,#,#,#,#,#, , , , ,#,#,#, , , , , ,#,#,#,#,#,#,#,
#,#,#,#,#, , , ,#,#,#, , , ,#,#,#,#,#,#,#,#,#,#,#,#,#,#,#, , , , ,#,#,#,#,#,#, , , ,#,#,#,#,#,#,#,#,
#,#,#,#,#,#, , , , , , , , ,#,#,#,#,#,#,#,#,#,#,#,#,#, , , , , ,#,#,#,#,#,#,#,#,#,#,#,#,#,#,#,#,#,#,
#,#,#,#,#,#,#, , , , , , , , ,#,#,#,#,#,#,#,#,#,#,#, , , , ,#,#,#,#,#,#,#,#,#,#,#,#,#,#,#,#,#,#,#,#,
#,#,#,#,#,#,#,#,#,#,#, , , , ,#,#,#,#,#,#,#,#,#,#,#,#, ,#,#,#,#,#,#,#,#,#,#,#,#,#,#,#,#,#,#,#,#,#,#,
#,#,#,#,#,#,#,#,#,#,#,#,#,#,#,#,#,#,#,#,#,#,#,#,#,#,#,#,#,#,#,#,#,#,#,#,#,#,#,#,#,#,#,#,#,#,#,#,#,#,
#,#,#,#,#,#,#,#,#,#,#,#,#,#,#,#,#,#,#,#,#,#,#,#,#,#,#,#,#,#,#,#,#,#,#,#,#,#,#,#,#,#,#,#,#,#,#,#,#,#,
#,#,#,#,#,#,#,#,#,#,#,#,#,#,#,#,#,#,#,#,#,#,#,#,#,#,#,#,#,#,#,#,#,#,#,#,#,#,#,#,#,#,#,#,#,#,#,#,#,#,
