#,#,#,#,#,#,#,#,#,#,#,#,#,#,#,#,#,#,#,#,#,#,#,#,#,#,#,#,#,#,#,#,#,#,#,#,#,#,#,#,#,#,#,#,#,#,#,#,#,#,
#,#,#,#,#,#,#,#,#,#,#,#,#,#,#,#,#,#,#,#,#,#,#,#,#, , , ,#,#,#,#,#,#,#,#,#,#,#,#, , , ,#,#,#,#,#,#,#,
#,#,#,#,#,#,#,#,#,#,#,#,#,#,#,#,#,#,#,#,#, , , , , , , , , ,#,#,#, , ,#,#,#, , , , , , , , , ,#,#,#,
#,#,#,#, , ,#,#,#,#,#,#,#,#,#,#,#,#,#,#, , , , , ,#,#,#, , , , , , , , , , , , ,#,#,#,#, , , , ,#,#,
#,#,#,#, , ,#,#,#,#,#,#, , , ,#,#,#,#,#, , , , ,#,#,#,#,#, , , , , , , , , , ,#,#,#,#,#,#, , , ,#,#,
#,#,#,#, , ,#,#,#,#,#,#, , , ,#,#,#,#,#,#, , , ,#,#,#,#,#,#, , , , , , , , , ,#,#,#,#,#,#, , , ,#,#,
#,#,#,#, , , ,#,#,#,#,#, , , ,#,#,#,#,#,#, , , ,#,#,#,#,#,#, , , , , , , , , ,#,#,#,#,#,#, , , ,#,#,
#,#,#,#, , , ,#,#,#,#,#, , , ,#,#,#,#,#,#,#, , , ,#,#,#,#, , , , , , , , , , , ,#,#,#,#, , , ,#,#,#,
#,#,#,#,#, , ,#,#,#,#, , , ,#,#,#,#,#,#,#,#,#, , , ,#,#, , , ,#,#,#, , , , , , , ,#,#, , , , ,#,#,#,
#,#,#,#,#, , , ,#,#, , , ,#,#,#,#,#,#,#,#,#,#,#, , , , , , ,#,#,#,#,#, , , , , , , , , , , , ,#,#,#,
#,#,#,#,#,#, , , , , , ,#,#,#,#,#,#,#,#,#,#,#,#, , , , , ,#,#,#,#,#,#, , ,#,#,#, , , , , , ,#,#,#,#,
#,#,#,#,#,#, , , , , , ,#,#,#,#,#,#,#,#,#,#,#, , , , , , ,#,#,#,#,#,#, , ,#,#,#, , , , , , ,#,#,#,#,
#,#,#,#,#,#, , , , , , ,#,#,#,#,#,#,#,#,#,#,#, , , , , , ,#,#,#,#,#,#, , , ,#, , , , , , , ,#,#,#,#,
#,#,#,#,#,#, , , , , , , ,#,#,#,#,#,#,#,#,#,#, , , , , , ,#,#,#,#,#,#,#, , , , , , , , , , ,#,#,#,#,
#,#,#,#,#,#, , , , , , , ,#,#,#,#,#,#,#,#,#, , , , , , , ,#,#,#,#,#,#,#, , , , , , , , , , , ,#,#,#,
#,#,#,#,#,#, , , , , , ,#,#,#,#,#,#,#,#,#,#, , , , , , , , ,#,#,#,#,#, , , , , , ,#,#, , , , ,#,#,#,
#,#,#,#,#, , , , , , , ,#,#,#,#,#,#,#,#,#, , , ,#,#, , , , ,#,#,#,#,#, , , , , ,#,#,#,#, , ,#,#,#,#,
#,#,#,#, , , , , , , , ,#,#,#,#,#,#,#,#,#, , ,#,#,#,#, , , ,#,#,#,#,#,#, , , ,#,#,#,#,#,#,#,#,#,#,#,
#,#,#, , , , ,#,#, , , , ,#,#,#,#,#,#,#, , , ,#,#,#,#,#, , ,#,#,#,#,#,#,#, , ,#,#,#,#,#,#,#,#,#,#,#,
#,#, , , , ,#,#,#,#, , , , , , , , , , , , ,#,#,#,#,#,#, , ,#,#,#,#,#,#,#, , ,#,#,#,#,#,#,#,#,#,#,#,
#,#, , , ,#,#,#,#,#,#, , , , , , , , , , ,#,#,#,#,#,#,#, , ,#,#,#,#,#,#, , , ,#,#,#,#,#,#,#,#,#,#,#,
#,#, , , ,#,#,#,#,#,#, , , , , , , , , ,#,#,#,#,#,#,#,#, , ,#,#,#,#,#,#, , , , ,#,#,#, , ,#,#,#,#,#,
#,#,#, , ,#,#,#,#,#, , , , , , , , , , ,#,#,#,#,#,#,#, , , ,#,#,#,#,#,#,#, , , , , , , , ,#,#,#,#,#,
#,#,#,#, , ,#,#,#, , , , , , , , , , , , ,#,#,#,#,#, , , ,#,#,#,#,#,#,#,#,#, , , , , , , ,#,#,#,#,#,
#,#,#,#, , , , , , , , , , , ,#,#, , , , , ,#,#,#, , , , ,#,#,#,#,#,#,#,#,#,#,#,#,#, , ,#,#,#,#,#,#,
#,#,#,#,#, , , , , ,#,#,#,#,#,#,#,#, , , , , , , , , , , ,#,#,#,#,#,#,#,#,#,#,#,#,#,#,#,#,#,#,#,#,#,
#,#,#,#,#,#,#,#,#,#,#,#,#,#,#,#,#,#, , , , , , , , , , ,#,#,#,#,#,#,#,#,#,#,#,#,#,#,#,#,#,#,#,#,#,#,
#,#,#,#,#,#,#,#,#,#,#,#,#,#,#,#,#,#, , , , , , , , ,#,#,#,#,#,#,#,#,#,#,#,#,#,#,#,#,#,#,#,#,#,#,#,#,
#,#,#,#,#,#,#,#,#,#,#,#,#,#,#,#,#,#,#, , , , , , ,#,#,#,#,#,#,#,#,#,#,#,#,#,#,#,#,#,#,#,#,#,#,#,#,#,
#,#,#,#,#,#,#,#,#,#,#,#,#,#,#,#,#,#,#, , , , , , ,#,#,#,#,#,#,#,#,#,#,#,#,#,#,#,#,#,#,#,#,#,#,#,#,#,
#,#,#,#,#,#,#,#,#,#,#,#,#,#,#,#,#,#, , , , , , , ,#,#,#,#,#,#,#,#,#,#,#,#,#,#,#,#,#,#,#,#,#,#,#,#,#,
#,#,#,#,#,#,#,#,#,#,#,#,#,#,#,#, , , , , , , , ,#,#,#,#,#,#,#,#,#,#,#,#,#,#,#,#,#,#,#,#,#,#,#,#,#,#,
#,#,#,#,#,#,#,#,#,#,#,#,#,#,#, , , ,#,#,#, , , ,#,#,#,#,#,#,#,#,#,#,#,#,#,#,#,#, , , , , ,#,#,#,#,#,
#,#,#,#, , ,#,#,#,#,#,#,#,#, , , ,#,#,#,#,#, , ,#,#,#,#,#,#,#,#,#,#,#,#,#, , , , , , , , , ,#,#,#,#,
#,#,#, , , , ,#,#,#,#,#,#,#, , ,#,#,#,#,#,#, , ,#,#,#,#,#,#,#,#,#,#,#,#, , , , ,#,#,#, , , ,#,#,#,#,
#,#,#, , , , , , ,#,#,#,#, , ,#,#,#,#,#,#,#, , , ,#,#,#,#,#,#,#,#,#,#, , , , ,#,#,#,#,#, , ,#,#,#,#,
#,#,#, , , , , , , , , , , , ,#,#,#,#,#,#,#,#, , , ,#,#,#,#,#,#,#,#,#, , , ,#,#,#,#,#,#, , ,#,#,#,#,
#,#, , , ,#,#,#, , , , , , , , ,#,#,#,#,#,#,#,#, , , ,#,#,#,#,#,#,#, , , , ,#,#,#,#,#,#, , ,#,#,#,#,
#,#, , ,#,#,#,#,#, , , , , , , , , , , ,#,#,#,#, , , ,#,#,#,#,#,#, , , , , ,#,#,#,#,#, , , ,#,#,#,#,
#, , ,#,#,#,#,#,#,#, , , , , , , , , , , , , ,#,#,#,#,#,#,#,#,#, , , , , , , ,#,#,#, , , ,#,#,#,#,#,
#, , ,#,#,#,#,#,#,#, , , , , , ,#,#,#, , , , , ,#,#,#,#,#,#,#,#, , , , , , , , , , , , ,#,#,#,#,#,#,
#,#, , ,#,#,#,#,#,#, , , , ,#,#,#,#,#,#,#,#, , , ,#,#,#,#,#,#,#,#, , , , ,#,#, , , , , ,#,#,#,#,#,#,
#,#, , ,#,#,#,#,#, , , , ,#,#,#,#,#,#,#,#,#,#, , , ,#,#,#,#,#,#,#,#, , ,#,#,#,#,#, , , , ,#,#,#,#,#,
#,#, , , ,#,#, , , , , ,#,#,#,#,#,#,#,#,#,#,#,#, , , ,#,#,#,#,#,#, , ,#,#,#,#,#,#,#, , , ,#,#,#,#,#,
#,#, , , , , , , , , ,#,#,#,#,#,#,#,#,#,#,#,#,#,#, , ,#,#,#,#,#,#, , ,#,#,#,#,#,#,#,#, , , ,#,#,#,#,
#,#, , , , , , , , ,#,#,#,#,#,#,#,#,#,#,#,#,#,#,#,#, , ,#,#,#,#, , ,#,#,#,#,#,#,#,#,#, , , ,#,#,#,#,
#,#,#, , , , ,#,#,#,#,#,#,#,#,#,#,#,#,#,#,#,#,#,#,#, , , , , , , ,#,#,#,#,#,#,#,#,#,#,#, ,#,#,#,#,#,
#,#,#,#, , ,#,#,#,#,#,#,#,#,#,#,#,#,#,#,#,#,#,#,#,#,#, , , , , ,#,#,#,#,#,#,#,#,#,#,#,#,#,#,#,#,#,#,
#,#,#,#,#,#,#,#,#,#,#,#,#,#,#,#,#,#,#,#,#,#,#,#,#,#,#,#, , , , ,#,#,#,#,#,#,#,#,#,#,#,#,#,#,#,#,#,#,
#,#,#,#,#,#,#,#,#,#,#,#,#,#,#,#,#,#,#,#,#,#,#,#,#,#,#,#,#,#,#,#,#,#,#,#,#,#,#,#,#,#,#,#,#,#,#,#,#,#,
