#,#,#,#,#,#,#,#,#,#,#,#,#,#,#,#,#,#,#,#,#,#,#,#,#,#,#,#,#,#,#,#,#,#,#,#,#,#,#,#,#,#,#,#,#,#,#,#,#,#,
#,#,#,#,#,#,#,#,#,#,#,#,#,#, , , , , ,#,#,#,#,#,#,#,#,#,#,#,#,#,#,#,#, , , ,#,#,#, , ,#,#,#,#,#,#,#,
#,#,#,#,#,#,#,#,#,#,#,#,#, , , , , , , ,#,#,#,#,#,#,#,#,#,#,#,#,#,#, , , , , ,#, , , , ,#,#,#,#,#,#,
#,#,#,#,#,#,#,#,#,#,#,#, , , ,#,#,#, , , ,#,#,#,#,#,#,#,#,#,#,#,#,#, , , , , ,#, , , , , ,#,#,#,#,#,
#,#,#,#,#,#,#,#,#,#,#, , , ,#,#,#,#,#, , , ,#,#,#,#,#,#,#,#,#,#,#,#,#, , , ,#,#,#, , , , ,#,#,#,#,#,
#,#,#,#,#,#,#,#,#,#, , , ,#,#,#,#,#,#, , , ,#,#,#,#,#,#,#,#,#,#,#,#,#, , , ,#,#,#,#, , , ,#,#,#,#,#,
#,#,#,#,#,#,#,#,#, , , ,#,#,#,#,#,#, , , ,#,#,#,#,#,#,#,#,#,#,#,#,#,#, , , ,#,#,#,#,#, , , ,#,#,#,#,
#,#,#, , , , , , , , ,#,#,#,#,#,#, , , ,#,#,#,#,#,#,#,#,#,#,#,#,#,#,#, , , ,#,#,#,#,#, , , ,#,#,#,#,
#,#, , , , , , , , ,#,#,#,#,#,#,#, , ,#,#,#,#,#,#,#,#,#,#,#,#,#,#,#, , , , , ,#,#,#, , , , ,#,#,#,#,
#, , , ,#,#,#,#,#,#,#,#,#,#,#,#,#,#,#,#,#,#,#,#,#,#,#,#,#,#,#,#,#, , , , , , , , , , , , , ,#,#,#,#,
#, , ,#,#,#,#,#,#,#,#,#,#,#,#,#,#,#,#,#,#,#,#,#,#,#,#,#,#,#,#, , , , , , , , , , , , , , ,#,#,#,#,#,
#, , ,#,#,#,#,#,#,#,#,#,#,#,#,#,#,#,#,#,#,#,#,#,#,#,#,#,#, , , , , , , , , , , ,#,#,#,#,#,#,#,#,#,#,
#,#, , ,#,#,#,#,#,#,#,#,#,#,#,#,#,#,#,#,#,#,#,#,#,#,#,#, , , ,#,#, , , , , , ,#,#,#,#,#,#,#,#,#,#,#,
#,#, , ,#,#,#,#,#,#,#,#,#,#,#,#,#,#,#,#,#,#,#,#,#,#,#,#, , ,#,#,#,#, , , ,#,#,#,#,#,#,#,#,#,#,#,#,#,
#,#,#, , ,#,#,#,#,#,#,#,#,#,#,#,#,#,#,#,#,#,#,#,#,#,#,#, , ,#,#,#,#, , ,#,#,#,#,#,#,#,#,#,#,#,#,#,#,
#,#,#,#, , , , ,#,#,#,#,#,#,#,#,#,#,#,#,#,#,#,#,#,#,#, , ,#,#,#,#,#, , ,#,#,#,#,#,#,#,#,#,#,#,#,#,#,
#,#,#,#, , , , , ,#,#,#,#,#,#,#,#,#, , , ,#,#,#,#,#, , , ,#,#,#,#,#, , ,#,#,#,#,#,#,#,#,#,#,#,#,#,#,
#,#,#,#, , , , , ,#,#,#,#, , , , , , , , , ,#,#,#, , , , ,#,#,#,#, , , ,#,#,#,#,#,#,#,#,#,#,#,#,#,#,
#,#,#,#, , , , ,#,#,#,#,#, , , , , , , , , , , , , , , , , ,#,#, , , ,#,#,#,#,#,#,#,#,#,#,#,#,#,#,#,
#,#,#,#, , , , ,#,#,#,#, , , , , , ,#,#, , , , , , , , , , , , , , ,#,#,#,#,#,#,#,#,#,#,#,#,#,#,#,#,
#,#,#, , , , , , ,#,#, , , , , , ,#,#,#,#, , , , , , , , , , , , ,#,#,#,#,#,#,#,#,#,#,#,#,#,#,#,#,#,
#,#, , , , , , , , , , , , , , , ,#,#,#,#,#, , , , ,#,#,#,#,#,#,#,#,#,#,#,#,#,#,#,#,#,#,#,#,#,#,#,#,
#, , , ,#,#, , , , , ,#,#, , , ,#,#,#,#,#,#,#, , ,#,#,#,#,#,#,#,#,#,#,#,#,#,#,#,#,#,#,#,#,#,#,#,#,#,
#, , ,#,#,#,#,#, , ,#,#,#,#, , ,#,#,#,#,#,#,#, , ,#,#,#,#,#,#,#,#,#,#,#,#,#,#,#,#,#, , ,#,#,#,#,#,#,
#, , ,#,#,#,#,#,#, ,#,#,#,#, , , ,#,#,#,#,#, , ,#,#,#,#,#,#,#,#,#,#,#,#,#,#,#,#,#, , , , ,#,#,#,#,#,
#, , ,#,#,#,#,#,#, , ,#,#,#, , , , , ,#,#, , , ,#,#,#,#,#,#,#,#,#,#,#,#,#,#,#, , , , , , , ,#,#,#,#,
#, , ,#,#,#,#,#,#, , ,#,#, , , , , , , , , , , ,#,#,#,#,#,#,#,#,#,#,#,#,#,#, , , , , , , , ,#,#,#,#,
#, , ,#,#,#,#,#,#, , , , , , ,#,#,#, , , , , ,#,#,#,#,#,#,#,#,#,#,#,#,#,#, , , , , ,#,#, , ,#,#,#,#,
#, , , ,#,#,#,#,#, , , , , ,#,#,#,#,#,#, , ,#,#,#,#,#,#,#,#,#,#,#,#,#,#, , , , , ,#,#,#,#, , ,#,#,#,
#, , , , ,#,#,#, , , , , , ,#,#,#,#,#,#,#,#,#,#,#,#,#,#,#,#,#,#,#,#,#, , , , , ,#,#,#,#,#, , , ,#,#,
#,#, , , , , , , , , , , , ,#,#,#,#,#,#,#,#,#,#,#,#,#,#,#,#,#,#,#,#,#, , , , , ,#,#,#,#,#, , , ,#,#,
#,#,#, , , , , , , , , , , ,#,#,#,#,#,#,#,#,#,#,#,#,#,#,#,#,#,#,#,#,#, , , , , , ,#,#,#,#, , ,#,#,#,
#,#,#,#, , , , , , , , ,#,#,#,#,#,#,#,#,#,#,#,#,#,#,#,#,#,#,#,#,#,#,#,#, , , , , , ,#,#, , , ,#,#,#,
#,#,#,#,#, , , , , ,#,#,#,#,#,#,#,#,#,#,#,#,#, , ,#,#,#,#,#,#,#,#,#,#,#,#, , , , , , , , , ,#,#,#,#,
#,#,#,#,#,#, , , , ,#,#,#,#,#,#,#,#,#,#, , , , , , , ,#,#,#,#,#,#,#,#,#,#,#, , , , , , , ,#,#,#,#,#,
#,#,#,#,#,#, , , , , ,#,#,#,#,#,#,#,#, , , , , , , , , ,#,#,#,#,#,#,#,#,#,#, , , , , , , ,#,#,#,#,#,
#,#,#,#,#,#, , , , , , ,#,#,#,#,#,#,#, , , ,#,#,#,#, , ,#,#,#,#,#,#,#,#,#,#, , , , , , ,#,#,#,#,#,#,
#,#,#,#,#, , , , , , , , ,#,#,#,#,#, , , ,#,#,#,#,#,#, , ,#,#,#,#,#,#,#,#, , , , , , , ,#,#,#,#,#,#,
#,#,#,#,#, , ,#,#,#, , , , ,#,#,#, , , ,#,#,#,#,#,#,#,#, , , , , ,#,#,#,#, , , , , , ,#,#,#,#,#,#,#,
#,#,#,#, , ,#,#,#,#,#, , , ,#,#,#, , , ,#,#,#,#,#,#,#,#, , , , , , ,#,#, , , , , , , ,#,#,#,#,#,#,#,
#,#,#, , , ,#,#,#,#,#, , , , , , , , , ,#,#,#,#,#,#,#, , , , ,#,#, , , , ,#,#,#, , , , ,#,#,#,#,#,#,
#,#, , , , ,#,#,#,#,#, , , , , , , , , , ,#,#, , , , , , , ,#,#,#,#, , ,#,#,#,#,#, , , ,#,#,#,#,#,#,
#,#, , , , , ,#,#,#,#, , , , , , , , , , , , , , , , , , , ,#,#,#,#, ,#,#,#,#,#,#,#, , ,#,#,#,#,#,#,
#,#, , , , , , ,#,#, , , , , , , ,#,#,#, , , , , , , , , , , ,#,#, , ,#,#,#,#,#,#,#, , ,#,#,#,#,#,#,
#,#, , , , , , , , , , ,#,#, , ,#,#,#,#,#,#,#,#,#,#, , , , , , , , , , ,#,#,#,#,#,#, , ,#,#,#,#,#,#,
#,#, , , , , , , , , ,#,#,#,#,#,#,#,#,#,#,#,#,#,#,#,#, , , , ,#,#, , , , ,#,#,#,#,#, , ,#,#,#,#,#,#,
#,#,#, , , , , , , ,#,#,#,#,#,#,#,#,#,#,#,#,#,#,#,#,#,#, , ,#,#,#,#, , , ,#,#,#,#,#,#,#,#,#,#,#,#,#,
#,#,#,#,#,#, , ,#,#,#,#,#,#,#,#,#,#,#,#,#,#,#,#,#,#,#,#,#,#,#,#,#,#,#,#,#,#,#,#,#,#,#,#,#,#,#,#,#,#,
#,#,#,#,#,#,#,#,#,#,#,#,#,#,#,#,#,#,#,#,#,#,#,#,#,#,#,#,#,#,#,#,#,#,#,#,#,#,#,#,#,#,#,#,#,#,#,#,#,#,
#,#,#,#,#,#,#,#,#,#,#,#,#,#,#,#,#,#,#,#,#,#,#,#,#,#,#,#,#,#,#,#,#,#,#,#,#,#,#,#,#,#,#,#,#,#,#,#,#,#,
