#,#,#,#,#,#,#,#,#,#,#,#,#,#,#,#,#,#,#,#,#,#,#,#,#,#,#,#,#,#,#,#,#,#,#,#,#,#,#,#,#,#,#,#,#,#,#,#,#,#,
#,#,#,#,#,#,#,#,#,#,#,#,#,#,#,#,#,#,#, , ,#,#,#,#,#,#,#,#,#, , , , , ,#,#,#,#,#,#,#,#,#,#,#,#,#,#,#,
#,#,#,#,#,#,#,#,#,#,#,#,#,#, , , , , , , , , , , , , , , , , , , , , , , ,#,#,#,#,#,#,#,#,#,#,#,#,#,
#,#,#,#,#,#,#,#,#,#,#,#,#, , , , , ,#,#,#, , , , , , , , , ,#,#,#,#,#, , , , ,#,#, , , ,#,#,#,#,#,#,
#,#,#, , , , ,#,#,#,#,#, , , , ,#,#,#,#,#,#, , , , , , , ,#,#,#,#,#,#,#, , , , , , , , , , , ,#,#,#,
#,#, , , , , , ,#,#,#, , , , ,#,#,#,#,#,#,#,#, , , , , , ,#,#,#,#,#,#,#, , , , , , , , , , , , ,#,#,
#, , , ,#,#,#, , , , , , , , ,#,#,#,#,#,#,#,#, , , , , , , ,#,#,#,#,#, , , , , , , ,#,#,#, , , ,#,#,
#, , ,#,#,#,#,#, , , , , , , ,#,#,#,#,#,#,#, , , , , , , , , ,#,#,#, , , , , , , ,#,#,#,#,#, , ,#,#,
#, , ,#,#,#,#,#, , , , , , , , , , , , , , , , , ,#,#,#, , , ,#,#, , , , , , , , ,#,#,#,#,#, , ,#,#,
#, , ,#,#,#,#,#, , , , , , , , , , , , , , , , ,#,#,#,#,#, , ,#,#, , , , , , , , ,#,#,#,#,#, , ,#,#,
#,#,#,#,#,#,#,#, , , , , , , , , , , , ,#,#,#,#,#,#,#,#,#, , ,#,#, , , , , , , , , ,#,#,#, , , ,#,#,
#,#,#,#,#,#,#,#, , , , , , , , , , ,#,#,#,#,#,#,#,#,#,#,#, , ,#,#, , , ,#,#,#, , , , , , , , , ,#,#,
#,#,#,#,#,#,#, , , , , ,#,#,#,#,#,#,#,#,#,#,#,#,#,#,#,#,#, , ,#,#, , , ,#,#,#, , , , , , , , , ,#,#,
#,#,#,#,#,#, , , , , ,#,#,#,#,#,#,#,#,#,#,#,#,#,#,#,#,#, , , ,#,#, , , ,#,#,#,#, , , , , , , ,#,#,#,
#,#,#,#,#,#, , , , , ,#,#,#,#,#,#,#,#,#,#,#,#,#,#,#,#, , , ,#,#,#, , , ,#,#,#,#,#,#, , , , ,#,#,#,#,
#,#,#,#,#,#,#, , , , , ,#,#,#,#,#,#,#,#,#,#,#,#,#,#, , , ,#,#,#,#, , , ,#,#,#,#,#,#,#,#,#,#,#,#,#,#,
#,#,#,#,#,#,#,#, , , , ,#,#,#,#,#,#,#,#,#,#,#,#,#,#, , ,#,#,#,#,#, , , , ,#,#,#,#,#,#,#,#,#,#,#,#,#,
#,#,#,#,#,#,#,#, , , ,#,#,#,#,#,#,#,#,#,#,#,#,#,#,#, , ,#,#,#,#,#, , , , , , , , ,#,#,#,#,#,#,#,#,#,
#,#,#,#,#,#,#,#, , ,#,#,#,#,#,#, , ,#,#,#,#,#,#,#,#, , ,#,#,#,#,#,#, , , , , , , , ,#,#,#,#,#,#,#,#,
#,#,#,#,#,#,#, , , ,#,#,#,#,#,#, , ,#,#,#,#,#,#,#,#, , ,#,#,#,#,#,#, , , ,#,#, , , ,#,#,#,#,#,#,#,#,
#,#,#,#,#,#,#, , , ,#,#,#,#,#,#, , , ,#,#,#,#,#,#,#, , ,#,#,#,#,#,#, , ,#,#,#,#, , ,#,#,#,#,#,#,#,#,
#,#,#,#,#,#,#,#, , ,#,#,#,#,#,#, , , ,#,#,#,#,#,#, , , , ,#,#,#,#, , , ,#,#,#,#, , ,#,#,#,#,#,#,#,#,
#,#,#,#,#,#,#,#,#, , ,#,#,#,#, , , ,#,#,#,#,#,#, , , , , , , , , , , , ,#,#,#, , , , ,#,#,#,#,#,#,#,
#,#,#,#,#,#,#,#,#,#, , , , , , , ,#,#,#,#,#,#, , , , , , , , , , , , , ,#,#,#,#, , , , ,#,#,#,#,#,#,
#,#,#,#,#,#,#,#,#,#,#, , , , , ,#,#,#,#,#,#, , , , , ,#,#,#,#,#,#,#, , , ,#,#,#,#, , , ,#,#,#,#,#,#,
#,#,#,#,#,#,#,#,#,#,#,#, , ,#,#,#,#,#,#,#, , , , , ,#,#,#,#,#,#,#,#,#, , ,#,#,#,#,#, , ,#,#,#,#,#,#,
#,#,#,#,#,#,#,#,#,#,#,#,#,#,#,#,#,#,#,#,#, , , , , ,#,#,#,#,#,#,#,#,#,#,#,#,#,#,#,#,#, , ,#,#,#,#,#,
#,#,#,#,#,#,#,#,#,#,#,#,#,#,#,#,#,#,#,#,#,#, , , ,#,#,#,#,#,#,#,#,#,#,#,#,#,#,#,#,#,#, , ,#,#,#,#,#,
#,#,#,#,#,#,#,#,#,#,#,#,#,#,#,#,#,#,#,#,#,#,#,#,#,#,#,#,#,#,#,#,#,#,#,#,#,#,#,#,#,#,#, , ,#,#,#,#,#,
#,#,#,#,#,#,#,#,#,#,#,#,#,#,#,#,#,#,#,#,#,#,#,#,#,#,#,#,#,#,#,#,#,#,#,#,#,#,#,#,#,#, , , ,#,#,#,#,#,
#,#,#,#,#,#,#,#,#,#,#,#,#,#,#,#,#,#,#,#,#,#,#,#,#,#,#,#,#,#,#,#,#, , , , , , ,#,#, , , ,#,#,#,#,#,#,
#,#,#,#,#,#,#,#,#,#,#,#,#,#,#,#,#,#,#,#,#,#,#,#,#,#,#,#,#,#,#,#, , , , , , , , , , , , ,#,#,#,#,#,#,
#,#,#,#,#, , , ,#,#,#,#,#,#,#,#,#,#,#, , , ,#,#,#,#,#,#,#,#,#,#, , , , , , , , , , , , ,#,#,#,#,#,#,
#,#,#, , , , , , ,#,#,#,#,#,#, , , , , , , , , , , ,#,#,#,#,#,#,#, , , , , , , , , , , ,#,#,#,#,#,#,
#,#, , , , , , , , ,#,#,#,#, , , , , , , , , , , , , ,#,#,#,#,#,#,#,#,#,#, , , , , , , ,#,#,#,#,#,#,
#,#, , , ,#,#,#, , , ,#,#, , , , , , , , , ,#,#, , , ,#,#,#,#,#,#,#,#,#,#,#, , , , , ,#,#,#,#,#,#,#,
#,#, , ,#,#,#,#,#, , , , , , , , , , , , ,#,#,#,#, , , ,#,#,#,#,#,#,#,#,#,#, , , , , ,#,#,#,#,#,#,#,
#,#, , ,#,#,#,#,#, , , , , , , , , , , ,#,#,#,#,#,#, , , ,#,#,#,#,#,#,#,#, , , , , ,#,#,#,#,#,#,#,#,
#,#, , ,#,#,#,#,#, , , , , , , , , , ,#,#,#,#,#,#,#,#, , , , , , , ,#,#, , , , , , ,#,#,#,#,#,#,#,#,
#,#, , , ,#,#,#, , , , , , , , , , ,#,#,#,#,#,#,#,#,#, , , , , , , , , , ,#,#,#, , , ,#,#,#,#,#,#,#,
#,#, , , , , , , , , , , , , , , ,#,#,#,#,#,#,#,#,#, , , , , , , , , , ,#,#,#,#,#, , , ,#,#,#,#,#,#,
#,#,#, , , , , , ,#,#,#,#, , , , ,#,#,#,#,#,#,#, , , , , , , , , , , ,#,#,#,#,#,#,#, , ,#,#,#,#,#,#,
#,#,#,#,#,#,#,#,#,#,#,#,#,#, , ,#,#,#,#,#,#, , , , , , , , , , , , , ,#,#,#,#,#,#,#, , , ,#,#,#,#,#,
#,#,#,#,#,#,#,#,#,#,#,#,#,#,#,#,#,#,#,#,#,#, , , ,#,#,#,#,#, , , , , , ,#,#,#,#,#,#, , , ,#,#,#,#,#,
#,#,#,#,#,#,#,#,#,#,#,#,#,#,#,#,#,#,#,#,#,#,#,#,#,#,#,#,#,#,#, , ,#,#, , ,#,#,#,#, , , ,#,#,#,#,#,#,
#,#,#,#,#,#,#,#,#,#,#,#,#,#,#,#,#,#,#,#,#,#,#,#,#,#,#,#,#,#,#,#,#,#,#,#, , ,#,#, , , ,#,#,#,#,#,#,#,
#,#,#,#,#,#,#,#,#,#,#,#,#,#,#,#,#,#,#,#,#,#,#,#,#,#,#,#,#,#,#,#,#,#,#,#, , , , , , ,#,#,#,#,#,#,#,#,
#,#,#,#,#,#,#,#,#,#,#,#,#,#,#,#,#,#,#,#,#,#,#,#,#,#,#,#,#,#,#,#,#,#,#,#,#, , , , ,#,#,#,#,#,#,#,#,#,
#,#,#,#,#,#,#,#,#,#,#,#,#,#,#,#,#,#,#,#,#,#,#,#,#,#,#,#,#,#,#,#,#,#,#,#,#,#, , ,#,#,#,#,#,#,#,#,#,#,
#,#,#,#,#,#,#,#,#,#,#,#,#,#,#,#,#,#,#,#,#,#,#,#,#,#,#,#,#,#,#,#,#,#,#,#,#,#,#,#,#,#,#,#,#,#,#,#,#,#,
