#,#,#,#,#,#,#,#,#,#,#,#,#,#,#,#,#,#,#,#,#,#,#,#,#,#,#,#,#,#,#,#,#,#,#,#,#,#,#,#,#,#,#,#,#,#,#,#,#,#,
#,#,#,#,#,#,#,#,#,#,#,#,#,#,#,#,#,#,#,#,#,#,#,#,#,#,#, , , , , ,#,#,#,#,#,#,#,#,#,#,#,#,#,#,#,#,#,#,
#,#,#,#,#,#,#,#,#,#,#,#,#,#,#,#,#, ,#,#,#,#,#,#,#, , , , , , , , ,#,#,#,#,#,#,#,#,#,#,#,#,#,#,#,#,#,
#,#,#,#,#,#,#,#,#,#,#,#,#,#,#,#, , , , ,#,#,#,#, , , ,#,#,#, , , , ,#,#,#, , , ,#,#,#,#,#, , ,#,#,#,
#,#,#,#,#,#,#, , , ,#,#,#,#,#,#,#, , , , , , , , , ,#,#,#,#,#, , , , , , , , , , , , , , , , , ,#,#,
#,#,#,#,#,#, , , , , ,#,#,#,#,#,#,#,#, , , , , , , ,#,#,#,#,#,#, , , , , , , , , , , , , , , , ,#,#,
#,#,#,#,#,#, , , , , ,#,#,#,#,#,#,#,#,#, , , , , , ,#,#,#,#,#,#,#, , , , , , , ,#,#,#,#, , , , ,#,#,
#,#,#,#,#,#,#, , , , ,#,#,#,#,#,#,#,#,#, , , , , , , ,#,#,#,#,#,#, , , , , , ,#,#,#,#,#,#, , ,#,#,#,
#,#,#,#,#,#,#, , , , ,#,#,#,#,#,#,#,#, , , , , , , , , ,#,#,#,#, , , , , , , ,#,#,#,#,#,#,#,#,#,#,#,
#,#, ,#,#,#,#, , , , ,#,#,#,#,#,#,#, , , ,#,#,#,#,#, , , ,#,#, , , , , , , , ,#,#,#,#,#,#,#,#,#,#,#,
#, , , ,#,#, , , , ,#,#,#,#,#,#, , , , ,#,#,#,#,#,#,#, , , , , , ,#,#,#,#, , , ,#,#,#,#,#,#,#,#,#,#,
#,#, , , , , , , ,#,#,#,#,#,#, , , , ,#,#,#,#,#,#,#,#, , , , , ,#,#,#,#,#,#, ,#,#,#,#,#,#,#,#,#,#,#,
#,#,#, , , , , ,#,#,#,#,#,#,#, , , ,#,#,#,#,#,#,#,#,#, , , , , ,#,#,#,#,#,#,#,#,#,#,#,#,#,#,#,#,#,#,
#,#,#,#, , ,#,#,#,#,#,#,#,#,#, , ,#,#,#,#,#,#,#,#,#,#,#, , , , ,#,#,#,#,#,#,#,#,#,#,#,#,#,#,#,#,#,#,
#,#,#,#, , ,#,#,#,#,#,#,#,#,#, , ,#,#,#,#,#,#,#,#,#,#,#, , , , ,#,#,#,#,#,#,#,#,#,#,#,#,#,#,#,#,#,#,
#,#,#,#, , ,#,#,#,#,#,#,#,#, , , ,#,#,#,#,#,#,#,#,#,#,#, , , , ,#,#,#,#,#,#,#,#,#,#,#,#,#,#,#,#,#,#,
#,#,#,#, , ,#,#,#,#, , , , , , , ,#,#,#,#,#,#,#,#,#,#,#, , , , , ,#,#,#,#,#,#,#,#,#,#,#,#,#,#,#,#,#,
#,#,#,#, , ,#,#,#, , , , , , , , ,#,#,#,#,#,#,#,#,#,#, , , , , , , , ,#,#,#,#,#,#,#,#,#,#,#,#,#,#,#,
#,#,#,#, , ,#,#, , , , , , , , , , ,#,#, , ,#,#,#,#, , , ,#,#,#, , , , ,#,#,#,#,#,#,#,#,#,#,#,#,#,#,
#,#,#, , , , , , , , , , , , , , , , , , , , ,#,#, , , ,#,#,#,#,#, , , , ,#,#,#,#,#,#,#,#,#,#,#,#,#,
#,#,#, , , , , , , , , , , , , , , , , , , , , , , , ,#,#,#,#,#,#,#, , , ,#,#,#,#,#,#,#,#,#,#,#,#,#,
#,#,#, , , , , , , , , , , , , , ,#,#,#, , , , , , , ,#,#,#,#,#,#,#,#, , ,#,#,#,#,#,#,#,#,#,#,#,#,#,
#,#, , ,#,#,#, , , , , , , , ,#,#,#,#,#,#, , , , , , , ,#,#,#,#,#,#,#, , ,#,#,#,#,#,#,#,#,#,#,#,#,#,
#, , ,#,#,#,#,#, , , , , , ,#,#,#,#,#,#,#, , , , , , , , , ,#,#,#,#,#,#, , ,#,#,#,#,#,#,#,#,#,#,#,#,
#, , ,#,#,#,#,#,#, , , , , ,#,#,#,#,#,#, , , , , , , , , , , , , ,#,#,#,#, , , , ,#,#,#,#,#,#,#,#,#,
#, , ,#,#,#,#,#,#, , , , , , ,#,#,#,#,#, , , , , , ,#,#,#,#,#, , , ,#,#,#, , , , , ,#,#,#,#,#,#,#,#,
#, , ,#,#,#,#,#,#, , , , , , , , ,#,#, , , , , , ,#,#,#,#,#,#,#, , , ,#,#, , , , , ,#,#,#,#,#,#,#,#,
#, , ,#,#,#,#,#,#, , , , , , , , , , , , , , ,#,#,#,#,#,#,#,#,#,#,#, , , , , , , , , ,#,#,#,#,#,#,#,
#, , , ,#,#,#,#, , , , , , , , , , , , , , ,#,#,#,#,#,#,#,#,#,#,#,#,#, , , , , , , , , , , , , ,#,#,
#,#, , , ,#,#, , , , ,#,#,#,#,#,#, , , , ,#,#,#,#,#,#,#,#,#,#,#,#,#,#, , , , , , , , , , , , , , ,#,
#,#,#, , , , , , , ,#,#,#,#,#,#,#,#,#,#,#,#,#,#,#,#,#,#,#,#,#,#,#,#,#, , , , , , , ,#,#,#,#, , , ,#,
#,#,#,#, , , , , ,#,#,#,#,#,#,#,#,#,#,#,#,#,#,#,#,#,#,#,#,#,#,#,#,#,#,#, , , , , ,#,#,#,#,#,#, , ,#,
#,#,#,#, , , , ,#,#,#,#,#,#,#,#,#,#,#,#,#,#,#,#,#,#,#,#,#,#,#,#,#,#,#,#,#, , , , ,#,#,#,#,#,#, , ,#,
#,#,#,#,#, , ,#,#,#,#, ,#,#,#,#,#,#,#,#,#,#,#,#,#,#,#,#,#,#,#,#,#,#,#,#,#, , , , ,#,#,#,#,#, , ,#,#,
#,#,#,#,#, , , ,#, , , , ,#,#,#,#,#,#,#,#,#,#,#,#,#,#,#,#,#,#,#,#, , ,#,#, , , , ,#,#,#,#,#, , ,#,#,
#,#,#,#,#, , , , , , , , ,#,#,#,#,#,#,#,#,#,#,#,#,#,#,#,#,#,#,#, , , , , , , , , ,#,#,#,#,#, , ,#,#,
#,#,#,#,#, , , , , , , , ,#,#,#,#,#,#,#,#,#,#,#,#,#,#,#,#,#,#, , , , , , , , , , , ,#,#,#, , ,#,#,#,
#,#,#,#,#, , , , ,#,#, , ,#,#,#,#,#,#,#,#,#,#,#,#,#,#, , , , , , , , , ,#, , , , , , , , , ,#,#,#,#,
#,#,#,#, , , , ,#,#,#,#, , ,#,#,#,#,#,#,#,#,#,#,#,#, , , , , , , , , , ,#, , , , , , , , ,#,#,#,#,#,
#,#,#,#, , , ,#,#,#,#,#, , ,#,#,#,#,#,#,#,#,#,#,#,#, , , ,#,#,#, , , , , , , , , , , , ,#,#,#,#,#,#,
#,#,#,#,#, , ,#,#,#,#,#, , ,#,#,#,#,#,#,#,#,#,#,#,#,#,#,#,#,#,#,#, , , , , , , , , , ,#,#,#,#,#,#,#,
#,#,#,#,#, , ,#,#,#,#,#, , ,#,#,#,#,#,#,#,#,#,#,#,#,#,#,#,#,#,#,#, , , ,#,#, , , ,#,#,#,#,#,#,#,#,#,
#,#,#,#,#, , ,#,#,#,#,#, , ,#,#,#,#,#,#,#,#,#,#,#,#,#,#,#,#,#,#,#, , ,#,#,#,#,#,#,#,#,#,#,#,#,#,#,#,
#,#,#,#,#, , , ,#,#,#, , , ,#,#,#,#,#,#,#,#,#,#,#,#,#,#,#,#,#,#, , , ,#,#,#,#,#,#,#,#,#,#,#,#,#,#,#,
#,#,#,#,#, , , , , , , , ,#,#,#,#,#,#,#,#,#,#,#,#,#,#,#,#,#, , , , , ,#,#,#,#,#,#,#,#,#,#,#,#,#,#,#,
#,#,#,#,#,#, , , , , , , ,#,#,#,#,#,#,#,#,#,#,#,#,#,#,#,#, , , , , ,#,#,#,#,#,#,#,#,#,#,#,#,#,#,#,#,
#,#,#,#,#,#,#,#,#, , , , ,#,#,#,#,#,#,#,#,#,#,#,#,#,#,#,#, , , , ,#,#,#,#,#,#,#,#,#,#,#,#,#,#,#,#,#,
#,#,#,#,#,#,#,#,#,#, , ,#,#,#,#,#,#,#,#,#,#,#,#,#,#,#,#,#,#, , ,#,#,#,#,#,#,#,#,#,#,#,#,#,#,#,#,#,#,
#,#,#,#,#,#,#,#,#,#,#,#,#,#,#,#,#,#,#,#,#,#,#,#,#,#,#,#,#,#,#,#,#,#,#,#,#,#,#,#,#,#,#,#,#,#,#,#,#,#,
#,#,#,#,#,#,#,#,#,#,#,#,#,#,#,#,#,#,#,#,#,#,#,#,#,#,#,#,#,#,#,#,#,#,#,#,#,#,#,#,#,#,#,#,#,#,#,#,#,#,
