#,#,#,#,#,#,#,#,#,#,#,#,#,#,#,#,#,#,#,#,#,#,#,#,#,#,#,#,#,#,#,#,#,#,#,#,#,#,#,#,#,#,#,#,#,#,#,#,#,#,
#,#,#,#,#,#,#,#, , , , , ,#,#,#,#,#,#,#,#,#,#,#,#,#,#,#,#,#,#,#,#,#,#,#,#,#,#,#,#,#,#,#,#,#,#,#,#,#,
#,#,#,#,#,#,#, , , , , , , , ,#,#,#,#,#,#,#,#,#,#,#,#,#,#,#,#, , , , , , ,#,#,#,#,#,#,#,#,#,#,#,#,#,
#,#,#,#,#,#, , ,#,#,#,#,#, , , ,#,#,#,#,#,#,#,#,#,#,#,#,#,#, , , , , , , , ,#,#,#,#,#,#,#,#,#,#,#,#,
#,#,#,#,#, , ,#,#,#,#,#,#,#, , ,#,#,#,#,#,#,#,#,#,#,#,#,#, , , , ,#,#,#, , , ,#,#,#,#,#,#,#,#,#,#,#,
#,#,#,#,#, , ,#,#,#,#,#,#,#, , ,#,#,#,#,#,#,#,#,#,#,#,#, , , , ,#,#,#,#,#, , , ,#,#,#,#,#,#,#,#,#,#,
#,#,#,#,#,#, , ,#,#,#,#,#,#, , ,#,#,#,#,#,#,#,#,#, , , , , , , ,#,#,#,#,#, , , , , ,#,#,#,#,#,#,#,#,
#,#,#,#,#,#, , ,#,#,#,#,#, , , ,#,#,#,#,#,#,#,#, , , , , , , , ,#,#,#,#,#,#, , , , , ,#,#,#,#,#,#,#,
#,#,#,#,#,#,#, , ,#,#,#,#, , , ,#,#,#,#,#,#,#,#, , , , , , , , ,#,#,#,#,#,#,#, , , , ,#,#,#,#,#,#,#,
#,#,#,#,#,#,#, , , ,#,#,#, , , ,#,#,#,#,#,#,#,#, , , , ,#,#, , , ,#,#,#,#,#,#, , , ,#,#,#,#,#,#,#,#,
#,#,#,#,#,#,#,#, , ,#,#,#, , ,#,#,#,#,#,#,#,#,#, , , ,#,#,#,#, , , ,#,#,#,#,#, , , ,#,#,#,#,#,#,#,#,
#,#,#,#,#,#,#,#, , ,#,#,#, , ,#,#,#,#,#,#,#,#,#, , , ,#,#,#,#,#, , , , ,#,#, , , ,#,#,#,#,#,#,#,#,#,
#,#,#,#,#,#,#,#, , ,#,#, , , ,#,#,#,#,#,#,#,#,#, , , ,#,#,#,#,#,#, , , , , , , , ,#,#,#,#,#,#,#,#,#,
#,#,#,#,#,#,#,#, , ,#,#, , , ,#,#,#,#,#,#,#,#, , , ,#,#,#,#,#,#,#,#, , , , , , , ,#,#,#,#,#,#,#,#,#,
#,#,#,#,#,#,#,#, , ,#,#, , , ,#,#,#,#,#,#,#, , , ,#,#,#,#,#,#,#,#,#,#,#, , , , , ,#,#,#,#,#,#,#,#,#,
#,#,#,#,#,#,#,#, , ,#,#,#, , , ,#,#,#,#,#, , , ,#,#,#,#,#,#,#,#,#,#,#,#,#, , , , ,#,#,#,#,#,#,#,#,#,
#,#,#,#,#,#,#, , , ,#,#,#,#, , , ,#,#,#, , , , ,#,#,#,#,#,#,#,#,#,#,#,#,#, , , , ,#,#,#,#,#,#,#,#,#,
#,#,#,#,#,#, , , ,#,#,#,#,#,#, , , , , , , , , ,#,#,#,#,#,#,#,#,#,#,#,#,#, , , , , ,#,#,#,#,#,#,#,#,
#,#,#,#,#, , , , ,#,#,#,#,#,#, , , , , , , , , ,#,#,#,#,#,#,#,#,#,#,#,#, , , , , , , , , , , ,#,#,#,
#,#,#,#, , , , , ,#,#,#,#,#,#, , , , , , , , , , ,#,#,#,#,#,#,#,#,#,#, , , , , ,#,#, , , , , , ,#,#,
#,#,#, , , , , , , ,#,#,#,#,#, , , , , , , , , , , ,#,#,#,#,#,#,#,#, , , , , ,#,#,#,#,#, , , , ,#,#,
#,#,#, , , , , , , , ,#,#,#, , , , , , , , , , , , , ,#,#,#,#,#,#,#, , , , , ,#,#,#,#,#,#, , ,#,#,#,
#,#,#,#, , , , , , , , , , , , , , , ,#,#,#,#,#, , , , ,#,#,#,#,#,#,#, , , , ,#,#,#,#,#,#, , ,#,#,#,
#,#,#,#,#,#,#,#,#,#, , , , , , , , ,#,#,#,#,#,#,#, , , ,#,#,#,#,#,#,#,#, , ,#,#,#,#,#,#, , , ,#,#,#,
#,#,#,#,#,#,#,#,#,#,#,#,#,#, , , , ,#,#,#,#,#,#,#,#, , , ,#,#,#,#,#,#,#, , ,#,#,#,#, , , , , ,#,#,#,
#,#,#,#, , ,#,#,#,#,#,#,#,#,#, , , , ,#,#,#,#,#,#,#, , , ,#,#,#,#,#,#, , , ,#,#,#, , , , , ,#,#,#,#,
#,#,#, , , , ,#,#,#,#,#,#,#,#, , , , , ,#,#,#,#,#,#, , , ,#,#,#,#,#, , , ,#,#,#, , ,#,#,#,#,#,#,#,#,
#,#,#, , , , , ,#,#,#,#,#,#,#,#, , , , , ,#,#,#,#,#, , , ,#,#,#,#,#, , ,#,#,#, , ,#,#,#,#,#,#,#,#,#,
#,#, , , , , , ,#,#,#,#,#,#,#,#,#,#,#, ,#,#,#,#,#, , , , , ,#,#,#, , , ,#,#, , , ,#,#,#,#,#,#,#,#,#,
#, , , ,#,#, , , ,#,#,#,#,#,#,#,#,#,#,#,#,#,#,#,#, , , , , , , , , , ,#,#, , , ,#,#,#,#,#,#,#,#,#,#,
#, , ,#,#,#,#, , , ,#,#,#,#,#,#,#,#,#,#,#,#,#,#,#, , , , , , , , , ,#,#,#, , , ,#,#,#,#,#,#,#,#,#,#,
#, , ,#,#,#,#, , , ,#,#,#,#,#,#,#,#,#,#,#,#,#,#,#,#, , , , ,#,#,#,#,#,#,#, , ,#,#,#,#,#,#,#,#,#,#,#,
#, , ,#,#,#,#,#, , ,#,#,#,#,#,#,#,#,#,#,#,#,#,#,#,#,#, , ,#,#,#,#,#,#,#,#, , ,#,#,#,#,#,#,#,#,#,#,#,
#, , ,#,#,#,#,#, , ,#,#,#,#,#,#,#,#,#,#,#,#,#,#,#,#,#, , ,#,#,#,#,#,#,#,#, , ,#,#,#,#,#,#,#,#,#,#,#,
#, , ,#,#,#,#,#, , ,#,#,#,#,#,#,#,#,#,#,#,#,#,#,#,#,#, , ,#,#,#,#,#,#,#,#, , , ,#,#,#,#,#,#,#,#,#,#,
#,#, , ,#,#,#, , , ,#,#,#,#,#,#,#,#,#,#,#,#,#,#,#,#,#, , ,#,#,#,#,#,#,#, , , , , ,#,#,#,#,#,#,#,#,#,
#,#, , , , , , , , ,#,#,#,#,#,#,#,#,#,#,#,#,#,#,#,#,#, , ,#,#,#,#, , , , , , , , , ,#,#,#,#,#,#,#,#,
#,#,#, , , , , , , , ,#,#,#,#,#,#,#,#,#,#,#,#,#,#,#,#, , , ,#,#, , , , , , , , , , , , ,#,#,#,#,#,#,
#,#,#,#, , , , , , , ,#,#,#,#,#,#,#,#,#,#,#,#,#,#,#, , , , , , , , , , , , , , , , , , , , ,#,#,#,#,
#,#,#,#, , , , , , , , ,#,#,#,#,#,#,#,#, , , , , , , , , , , , , , , , , , , , ,#,#,#,#, , , ,#,#,#,
#,#,#,#, , , , ,#,#, , , , ,#,#,#,#,#, , , , , , , , , , , , , , , , , , , , ,#,#,#,#,#,#, , ,#,#,#,
#,#,#,#, , , ,#,#,#,#,#, , , ,#,#, , , , , ,#,#,#,#,#,#, , , , , , , , ,#, , ,#,#,#,#,#,#, , , ,#,#,
#,#,#,#, , , ,#,#,#,#,#,#, , , , , , , ,#,#,#,#,#,#,#,#,#, , , , , , ,#,#,#, , ,#,#,#,#,#, , , ,#,#,
#,#,#,#, , , ,#,#,#,#,#,#, , , , , , ,#,#,#,#,#,#,#,#,#,#, , , , , ,#,#,#,#, , , ,#,#,#, , , , ,#,#,
#,#,#,#,#, , ,#,#,#,#,#,#, , , , , , ,#,#,#,#,#,#,#,#,#,#, , , , ,#,#,#,#,#, , , , , , , , , , ,#,#,
#,#,#,#,#, , , ,#,#,#,#, , , , , , , , ,#,#,#,#,#,#,#,#, , , ,#,#,#,#,#,#,#,#, , , , , , , , , ,#,#,
#,#,#,#,#,#, , , , , , , , , ,#,#,#, , , , ,#,#,#,#, , , , ,#,#,#,#,#,#,#,#,#, , , , , , , , ,#,#,#,
#,#,#,#,#,#,#, , , , , , , ,#,#,#,#,#, , , , , , , , , , ,#,#,#,#,#,#,#,#,#,#,#, , , ,#,#,#,#,#,#,#,
#,#,#,#,#,#,#,#,#,#,#, , ,#,#,#,#,#,#,#,#, , , , , , ,#,#,#,#,#,#,#,#,#,#,#,#,#,#,#,#,#,#,#,#,#,#,#,
#,#,#,#,#,#,#,#,#,#,#,#,#,#,#,#,#,#,#,#,#,#,#,#,#,#,#,#,#,#,#,#,#,#,#,#,#,#,#,#,#,#,#,#,#,#,#,#,#,#,
