#,#,#,#,#,#,#,#,#,#,#,#,#,#,#,#,#,#,#,#,#,#,#,#,#,#,#,#,#,#,#,#,#,#,#,#,#,#,#,#,#,#,#,#,#,#,#,#,#,#,
#,#,#,#,#,#,#,#, , , ,#,#,#,#,#,#,#,#,#,#,#,#,#,#,#,#,#,#,#,#,#,#,#,#, , , ,#,#,#,#,#,#,#,#,#,#,#,#,
#,#,#, , , , , , , , , , ,#,#,#,#,#,#,#,#,#,#,#,#,#,#,#,#,#,#,#,#, , , , , , , ,#,#,#,#,#,#,#,#,#,#,
#,#, , , , , , ,#,#,#, , , ,#,#,#,#,#,#,#,#,#,#,#,#,#,#,#,#,#,#, , , ,#,#,#, , , , ,#,#,#,#,#,#,#,#,
#,#, , , , , ,#,#,#,#,#, , , ,#,#,#,#,#,#,#,#,#,#,#,#,#,#,#,#,#, , ,#,#,#,#,#, , , , ,#,#,#,#,#,#,#,
#,#,#, , , , ,#,#,#,#,#,#, , , ,#,#,#,#,#,#,#,#,#,#,#,#,#,#,#, , , ,#,#,#,#,#, , , , , ,#,#,#,#,#,#,
#,#,#,#, , , ,#,#,#,#,#,#,#, , ,#,#,#,#,#,#,#,#,#,#,#,#,#,#,#, , , ,#,#,#,#,#, , , , , ,#,#,#,#,#,#,
#,#,#,#,#, , ,#,#,#,#,#,#,#, , ,#,#,#,#,#,#,#,#,#,#,#,#,#,#,#,#, , , ,#,#,#, , , , , , ,#,#,#,#,#,#,
#,#,#,#,#,#, , ,#,#,#,#,#,#, , ,#,#,#,#,#,#,#,#,#,#,#,#,#,#,#,#,#, , , , , , , , , , ,#,#,#,#,#,#,#,
#,#,#,#,#,#, , , ,#,#,#,#, , ,#,#,#,#,#,#,#,#,#,#,#,#,#,#,#,#,#,#,#, , , , , , , , , ,#,#,#,#,#,#,#,
#,#,#,#,#,#,#, , ,#,#,#,#, , ,#,#,#,#,#,#,#,#,#,#,#,#,#,#,#,#,#,#,#,#,#, , , , , , , ,#,#,#,#,#,#,#,
#,#,#,#,#,#,#, , ,#,#,#,#, , ,#,#,#,#,#,#,#,#,#,#,#,#,#,#,#,#,#,#,#,#,#,#, , ,#,#, , ,#,#,#,#,#,#,#,
#,#,#,#,#,#,#, , ,#,#,#, , ,#,#,#,#,#,#,#,#,#,#,#,#,#,#,#,#,#,#,#,#,#,#,#, , , , , , ,#,#,#,#,#,#,#,
#,#,#,#,#,#, , , , , , , , ,#,#,#,#,#,#, , ,#,#,#,#,#,#,#,#,#,#,#,#,#,#,#,#, , , , , , ,#,#,#,#,#,#,
#,#,#,#,#,#, , , , , , , , ,#,#,#,#,#, , , , , , , , , ,#,#,#,#,#,#,#,#,#,#,#, , , , , , , , ,#,#,#,
#,#,#,#,#, , , , , , , , , ,#,#,#,#,#, , , , , , , , , , ,#,#,#,#,#,#,#,#,#,#, , , , , , , , , ,#,#,
#,#,#,#,#, , , , , , , , ,#,#,#,#,#, , , ,#,#,#,#, , , , ,#,#,#,#,#,#,#,#,#,#, , , ,#,#,#,#, , ,#,#,
#,#,#,#, , , , , , , , ,#,#,#,#,#, , , ,#,#,#,#,#,#, , , ,#,#,#,#,#,#,#,#,#,#, , ,#,#,#,#,#,#, ,#,#,
#,#,#, , , , , , , , , , ,#, , , , , ,#,#,#,#,#,#,#, , , ,#,#,#,#,#,#,#,#,#,#, ,#,#,#,#,#,#,#, , ,#,
#,#, , , , , , , , , , , , , , , , , ,#,#,#,#,#,#,#, , , ,#,#,#,#,#,#,#,#,#, , ,#,#,#,#,#,#,#, , ,#,
#,#, , , ,#,#,#, , , , , , , , , , , , ,#,#,#,#,#,#, , , ,#,#,#,#,#,#,#,#,#, , ,#,#,#,#,#,#, , ,#,#,
#,#, , ,#,#,#,#,#, , , , , , , , , , , ,#,#,#,#,#,#, , , , ,#,#,#,#,#,#,#, , , , ,#,#,#,#, , , ,#,#,
#,#, , ,#,#,#,#,#,#, , , , , , , , , ,#,#,#,#,#,#,#, , , , , ,#,#,#,#,#, , , , , , , , , , , ,#,#,#,
#,#, , ,#,#,#,#,#,#, , , , , , , , ,#,#,#,#,#,#,#, , , , , , , ,#,#,#, , , , , , , , , , ,#,#,#,#,#,
#,#,#, , ,#,#,#,#, , , ,#,#,#, , ,#,#,#,#,#,#,#,#, , , , , , , , , , , , , , , , , ,#,#,#,#,#,#,#,#,
#,#,#,#, , , , , , , ,#,#,#,#,#,#,#,#,#,#,#,#,#,#,#, , , , , , , , , , , , , , , ,#,#,#,#,#,#,#,#,#,
#,#,#,#, , , , , , ,#,#,#,#,#,#,#,#,#,#,#,#,#,#,#,#,#,#,#,#, , , , , , , , , , , ,#,#,#,#,#,#,#,#,#,
#,#,#,#,#, , ,#,#,#,#,#,#,#,#,#,#,#,#,#,#,#,#,#,#,#,#,#,#,#,#,#,#,#,#,#,#, , , , ,#,#,#,#,#,#,#,#,#,
#,#,#,#,#,#,#,#,#,#,#,#,#,#,#,#,#,#,#,#,#,#,#,#,#,#,#,#,#,#,#,#,#,#,#,#,#,#, , , ,#,#,#,#,#,#,#,#,#,
#,#,#,#,#,#,#,#,#,#,#,#,#,#,#,#,#,#,#,#,#,#,#,#,#,#,#,#,#,#,#,#,#,#,#,#,#,#, , , ,#,#,#,#,#,#,#,#,#,
#,#,#,#,#,#,#,#,#, , , , ,#,#, , ,#,#,#,#,#,#,#,#,#,#,#,#,#,#,#,#,#,#,#,#,#, , , ,#,#,#,#,#,#,#,#,#,
#,#,#,#,#,#,#,#,#, , , , , , , , , ,#,#,#,#,#,#,#,#,#,#,#,#, , ,#,#,#,#,#, , , ,#,#,#,#,#,#,#,#,#,#,
#,#,#,#,#,#,#,#,#,#,#, , , , , , , ,#,#,#,#,#,#,#,#,#,#,#, , , , ,#,#,#, , , ,#,#,#,#,#,#,#,#,#,#,#,
#,#,#,#,#,#,#,#,#,#,#,#, , , , , , , ,#,#,#,#,#,#,#,#,#, , , , , , , , , , , ,#,#,#,#,#,#,#,#,#,#,#,
#,#,#,#,#,#,#,#,#,#,#,#,#, , , , , , , ,#,#,#,#,#,#,#, , , , , , , , , , , , , ,#,#,#,#,#,#,#,#,#,#,
#,#, , ,#,#,#,#,#,#,#,#,#,#, , , , , , , ,#,#,#,#, , , , , , , , , , , , , , , , , ,#,#,#,#,#,#,#,#,
#, , , , , , ,#,#,#,#,#,#,#,#,#,#, , , , , ,#,#, , , , , , , , , , , , , , , , , , , ,#,#,#,#,#,#,#,
#, , , , , , ,#,#,#,#,#,#,#,#,#,#,#,#, , , , , , , , ,#,#, , , , , , , , , , , , , , , , ,#,#,#,#,#,
#, , , ,#,#,#,#,#,#,#,#,#,#,#,#,#,#,#,#, , , , , ,#,#,#,#,#, , , , , , , , , , ,#,#, , , , ,#,#,#,#,
#, , ,#,#,#,#,#,#,#,#,#,#,#,#,#,#,#,#,#, , ,#,#,#,#,#,#,#,#,#, , , , , , , , ,#,#,#,#, , , , ,#,#,#,
#, , ,#,#,#,#,#,#,#,#,#,#,#,#,#,#,#, , , , ,#,#,#,#,#,#,#,#,#,#,#,#,#, , , , ,#,#,#,#,#, , , ,#,#,#,
#, , ,#,#,#,#,#,#, , , ,#,#,#,#,#, , , , , ,#,#,#,#,#,#,#,#,#,#,#,#,#,#, , , ,#,#,#,#,#, , , ,#,#,#,
#, , , ,#,#,#, , , , , , , , , , , , , , , , , , ,#,#,#,#,#,#,#,#,#,#,#, , , ,#,#,#,#,#, , ,#,#,#,#,
#, , , , , , , , , , , , , , , , , , , , , , , , , ,#,#,#,#,#,#,#,#,#,#,#, , , ,#,#,#, , ,#,#,#,#,#,
#,#, , , , , , , , ,#,#,#, , , , , , , , , , , , , , , , ,#,#,#,#,#,#,#,#,#, , , , , , , ,#,#,#,#,#,
#,#,#, , , , , , ,#,#,#,#,#, , , , ,#,#, , , , , , , , , , ,#,#,#,#,#,#,#,#,#, , , , , ,#,#,#,#,#,#,
#,#,#,#, , , , ,#,#,#,#,#,#,#,#,#,#,#,#,#,#,#,#,#,#, , , ,#,#,#,#,#,#,#,#,#,#,#,#,#,#,#,#,#,#,#,#,#,
#,#,#,#,#, , ,#,#,#,#,#,#,#,#,#,#,#,#,#,#,#,#,#,#,#,#,#,#,#,#,#,#,#,#,#,#,#,#,#,#,#,#,#,#,#,#,#,#,#,
#,#,#,#,#,#,#,#,#,#,#,#,#,#,#,#,#,#,#,#,#,#,#,#,#,#,#,#,#,#,#,#,#,#,#,#,#,#,#,#,#,#,#,#,#,#,#,#,#,#,
#,#,#,#,#,#,#,#,#,#,#,#,#,#,#,#,#,#,#,#,#,#,#,#,#,#,#,#,#,#,#,#,#,#,#,#,#,#,#,#,#,#,#,#,#,#,#,#,#,#,
