#,#,#,#,#,#,#,#,#,#,#,#,#,#,#,#,#,#,#,#,#,#,#,#,#,#,#,#,#,#,#,#,#,#,#,#,#,#,#,#,#,#,#,#,#,#,#,#,#,#,
#,#,#,#,#,#,#,#,#,#, , , , , , , , , ,#,#,#,#,#,#,#,#,#,#,#,#,#, , , , , , , ,#,#,#,#,#,#,#,#,#,#,#,
#,#,#,#,#,#,#,#,#, , , , , , , , , , , ,#,#,#,#,#,#,#,#,#,#,#, , , , , , , , , ,#,#,#,#,#,#,#,#,#,#,
#,#,#,#,#,#,#, , , , ,#,#,#, , , , , , , ,#,#,#,#,#,#,#,#,#,#, , ,#,#,#,#,#, , , ,#,#,#,#,#,#,#,#,#,
#,#,#,#,#, , , , , ,#,#,#,#,#, , , , , , , ,#,#,#,#,#,#,#,#, , ,#,#,#,#,#,#,#, , , , , , , ,#,#,#,#,
#,#,#,#, , , , , ,#,#,#,#,#,#, , , , , , , , ,#,#,#,#,#,#,#, , ,#,#,#,#,#,#,#, , , , , , , ,#,#,#,#,
#,#, , , , ,#,#,#,#,#,#,#,#, , , , , , , , , , ,#,#,#,#,#, , , ,#,#,#,#,#,#,#, , , , , ,#,#,#,#,#,#,
#, , , ,#,#,#,#,#,#, , , , , , , ,#,#, , , , , ,#,#,#,#,#, , ,#,#,#,#,#,#,#,#, , , , ,#,#,#,#,#,#,#,
#, , ,#,#,#,#,#,#, , , , , , , ,#,#,#,#, , , ,#,#,#,#,#,#, , ,#,#,#,#,#,#,#,#, , , , ,#,#,#,#,#,#,#,
#, , ,#,#,#,#,#,#, , ,#,#,#,#,#,#,#,#,#,#,#,#,#,#,#,#,#,#, , , ,#,#,#,#,#,#,#,#, , , ,#,#,#,#,#,#,#,
#,#, ,#,#,#,#,#, , ,#,#,#,#,#,#,#,#,#,#,#,#,#,#,#,#,#,#, , , , , , , , , ,#,#,#,#, , ,#,#,#,#,#,#,#,
#,#, , ,#,#,#, , ,#,#,#,#,#,#,#,#,#,#,#,#,#,#,#,#,#,#, , , , , , , , , , , ,#,#,#, , ,#,#,#,#,#,#,#,
#,#, , , , , , , ,#,#,#,#,#,#,#,#,#,#,#,#,#,#,#,#,#, , , , , , , , , , , , ,#,#,#, , ,#,#,#,#,#,#,#,
#,#,#, , , , , ,#,#,#,#,#,#,#,#,#,#,#,#,#,#, , , , , , , , , , , , , , , , ,#,#,#, , , ,#,#,#,#,#,#,
#,#,#, , , , , ,#,#,#,#,#,#,#,#,#,#,#,#,#, , , , , , , , , , , , , ,#,#, , ,#,#,#,#, ,#,#,#,#,#,#,#,
#,#,#, , , , , ,#,#,#,#,#,#,#,#,#,#,#,#, , ,#,#,#,#, , , , , , , ,#,#,#,#, , ,#,#,#,#,#,#,#,#,#,#,#,
#,#,#, , , , , ,#,#,#,#,#,#,#,#,#,#,#, , ,#,#,#,#,#,#, , , , , , , ,#,#, , , ,#,#,#,#,#,#,#,#,#,#,#,
#,#,#, , , , , , ,#,#,#,#,#,#,#,#,#, , ,#,#,#,#,#,#,#, , ,#,#,#, , , , , , , ,#,#,#,#,#,#,#,#,#,#,#,
#,#, , , , , , , , ,#,#,#,#,#,#,#,#, , ,#,#,#,#,#,#,#, , ,#,#,#, , , , , , , ,#,#,#,#,#,#,#,#,#,#,#,
#, , , ,#,#,#, , , , ,#,#,#,#,#,#,#, , ,#,#,#,#,#,#, , , ,#,#,#,#, , , , , , ,#,#,#,#,#,#,#,#,#,#,#,
#, , ,#,#,#,#,#, , , ,#,#,#,#,#,#, , , , ,#,#,#, , , , ,#,#,#,#,#,#,#, , , , ,#,#,#,#,#,#,#,#,#,#,#,
#, , ,#,#,#,#,#,#, , ,#,#,#,#,#,#, , , , , , , , , , ,#,#,#,#,#,#,#,#,#,#,#, , ,#,#,#,#, ,#,#,#,#,#,
#, , ,#,#,#,#,#,#, , ,#,#,#,#,#,#, , , , , , , , ,#,#,#,#,#,#,#,#,#,#,#,#,#,#, , , , , , , ,#,#,#,#,
#,#, , ,#,#,#,#, , , , ,#,#,#,#,#, , , , , , , ,#,#,#,#,#,#,#,#,#,#,#,#,#,#,#,#, , , , , ,#,#,#,#,#,
#,#, , , ,#,#, , , , , , , ,#,#, , , , , ,#,#,#,#,#,#,#,#,#,#,#,#,#,#,#,#,#,#,#,#, , , ,#,#,#,#,#,#,
#,#,#, , , , , , , , , , , , , , , , , ,#,#,#,#,#,#,#,#,#,#,#,#,#,#,#,#,#,#,#,#,#,#,#,#,#,#,#,#,#,#,
#,#,#,#, , , , , , ,#,#,#,#, , , , , ,#,#,#,#,#,#,#,#,#,#,#,#,#,#,#,#,#,#,#,#,#,#,#,#,#,#,#,#,#,#,#,
#,#,#,#,#,#,#, , ,#,#,#,#,#,#,#, , ,#,#,#,#,#,#,#,#,#,#,#,#,#,#,#,#,#,#,#,#,#,#,#,#,#,#,#,#,#,#,#,#,
#,#,#,#,#,#,#,#, ,#,#,#,#,#,#,#,#,#,#,#,#,#,#,#,#,#,#,#,#,#,#,#,#,#,#,#,#,#,#,#,#,#,#,#,#,#,#,#,#,#,
#,#,#,#,#,#,#,#, , ,#,#,#,#,#,#,#,#,#,#,#,#,#,#,#,#,#,#,#,#,#,#,#,#,#,#,#,#,#,#,#,#,#,#,#,#,#,#,#,#,
#,#,#,#,#,#,#,#, , ,#,#,#,#,#,#,#,#,#,#,#,#,#,#,#,#,#,#,#,#,#,#,#,#,#,#,#,#,#,#,#,#,#,#,#,#,#,#,#,#,
#,#,#,#,#,#,#,#, , ,#,#,#,#,#,#,#,#,#,#,#,#,#,#,#,#,#,#,#,#,#,#,#,#,#,#,#,#,#,#,#,#,#,#,#,#,#,#,#,#,
#,#,#,#,#,#,#,#, , , ,#,#,#,#,#,#,#,#, , ,#,#,#,#,#,#,#,#,#,#,#,#,#,#,#,#,#,#, , , ,#,#,#,#,#,#,#,#,
#,#,#,#,#,#,#, , , , , , ,#,#,#,#,#, , , , ,#,#,#,#,#,#,#,#,#,#,#,#,#,#,#,#, , , , , ,#,#,#,#,#,#,#,
#,#,#,#,#, , , , , , , , , , ,#,#,#, , , , ,#,#,#,#,#,#,#,#,#,#,#,#,#,#,#, , , , , , , ,#,#,#,#,#,#,
#,#,#, , , , , , , , , , , , , ,#,#,#, , , , ,#,#,#,#,#,#,#,#,#,#,#,#,#,#, , ,#,#, , , , ,#,#,#,#,#,
#,#, , , , , , , , , , , , , , , ,#,#,#, , , , , , , ,#,#,#,#,#,#,#,#,#, , ,#,#,#,#, , , ,#,#,#,#,#,
#,#, , , , , , , , , , , , , , , , ,#,#,#, , , , , , , ,#,#, , , , , , , ,#,#,#,#,#, , , ,#,#,#,#,#,
#, , , ,#,#,#,#,#, , , , ,#,#,#, , , ,#,#,#, , , , , , , , , , , , , , , ,#,#,#,#,#, , , ,#,#,#,#,#,
#, , ,#,#,#,#,#,#, , , ,#,#,#,#,#, , ,#,#,#,#, , , , , , , , , , , , , , ,#,#,#,#, , , , ,#,#,#,#,#,
#, , ,#,#,#,#,#,#, , , ,#,#,#,#,#, , ,#,#,#,#,#, , , , , , , , , , , , , , ,#,#, , , , ,#,#,#,#,#,#,
#, , ,#,#,#,#,#,#, , ,#,#,#,#,#,#, , ,#,#,#,#,#, , , , , , , , , , , , , , , , , , , ,#,#,#,#,#,#,#,
#, , , ,#,#,#,#, , , ,#,#,#,#,#,#, , ,#,#,#,#, , , , , , , , , , ,#,#,#, , , , , , ,#,#,#,#,#,#,#,#,
#,#, , , , , , , , , ,#,#,#,#,#,#, , ,#,#,#,#, , ,#,#,#,#,#,#,#,#,#,#,#,#, , , , ,#,#,#,#,#,#,#,#,#,
#,#,#,#, , , , , , ,#,#,#,#,#,#,#,#, , ,#,#, , ,#,#,#,#,#,#,#,#,#,#,#,#,#,#,#,#,#,#,#,#,#,#,#,#,#,#,
#,#,#,#,#,#,#,#,#,#,#,#,#,#,#,#,#,#, , , , , , ,#,#,#,#,#,#,#,#,#,#,#,#,#,#,#,#,#,#,#,#,#,#,#,#,#,#,
#,#,#,#,#,#,#,#,#,#,#,#,#,#,#,#,#,#, , , , , ,#,#,#,#,#,#,#,#,#,#,#,#,#,#,#,#,#,#,#,#,#,#,#,#,#,#,#,
#,#,#,#,#,#,#,#,#,#,#,#,#,#,#,#,#,#,#, , , ,#,#,#,#,#,#,#,#,#,#,#,#,#,#,#,#,#,#,#,#,#,#,#,#,#,#,#,#,
#,#,#,#,#,#,#,#,#,#,#,#,#,#,#,#,#,#,#,#,#,#,#,#,#,#,#,#,#,#,#,#,#,#,#,#,#,#,#,#,#,#,#,#,#,#,#,#,#,#,
#,#,#,#,#,#,#,#,#,#,#,#,#,#,#,#,#,#,#,#,#,#,#,#,#,#,#,#,#,#,#,#,#,#,#,#,#,#,#,#,#,#,#,#,#,#,#,#,#,#,
