#,#,#,#,#,#,#,#,#,#,#,#,#,#,#,#,#,#,#,#,#,#,#,#,#,#,#,#,#,#,#,#,#,#,#,#,#,#,#,#,#,#,#,#,#,#,#,#,#,#,
#,#,#,#,#,#,#,#,#,#,#,#,#,#,#, , , , ,#,#,#,#,#,#,#,#,#,#,#,#,#,#,#,#,#,#,#,#,#,#,#,#,#,#,#,#,#,#,#,
#,#,#,#,#,#,#,#,#,#,#,#,#, , , , , , , , ,#,#,#,#,#,#,#,#,#,#,#,#,#,#,#,#,#,#,#,#,#,#,#,#,#,#,#,#,#,
#,#,#,#,#,#,#,#, ,#,#, , , , ,#,#,#, , , , ,#,#,#, , , ,#,#,#,#,#,#,#,#,#,#,#,#,#, , , , ,#,#,#,#,#,
#,#,#,#,#,#,#, , , , , , , ,#,#,#,#,#, , , , , , , , , , , , , , , , , , , , , , , , , , , ,#,#,#,#,
#,#,#,#,#,#,#,#, , , , , ,#,#,#,#,#,#,#, , , , , , , , , , , , , , , , , , , , , ,#,#,#, , , ,#,#,#,
#,#,#,#,#,#,#,#,#,#,#,#,#,#,#,#,#,#,#,#,#, , , , , , , ,#,#,#,#,#,#, , , , , , ,#,#,#,#,#, , , ,#,#,
#,#,#,#,#,#,#,#,#,#,#,#,#,#,#,#,#,#,#,#,#, , , , , , ,#,#,#,#,#,#,#,#, , , , , ,#,#,#,#,#, , , ,#,#,
#,#,#,#,#,#,#,#,#,#, , , , , ,#,#,#,#,#, , , , , , , ,#,#,#,#,#,#,#,#, , , , , ,#,#,#,#,#, , , ,#,#,
#,#,#,#,#,#,#,#,#, , , , , , , , , , , , , , , , , , , ,#,#,#,#,#,#, , , , , , , ,#,#,#,#, , , ,#,#,
#,#,#,#,#,#,#,#,#, , , ,#,#, , , , , , , , , , , , , , ,#,#,#,#,#, , , ,#,#,#,#, , ,#,#, , , , ,#,#,
#, , ,#,#,#,#,#, , , ,#,#,#,#,#,#,#, , , , , ,#,#, , , , ,#,#,#,#, , ,#,#,#,#,#,#, , , , , , ,#,#,#,
#, , , ,#,#,#, , , , ,#,#,#,#,#,#,#,#, , , ,#,#,#, , , , ,#,#,#,#, , ,#,#,#,#,#,#,#, , , , , ,#,#,#,
#,#, , , , , , , , ,#,#,#,#,#,#,#,#,#,#,#,#,#,#,#, , , , , ,#,#, , , ,#,#,#,#,#,#,#,#, , , ,#,#,#,#,
#,#, , , , , , ,#,#,#,#,#,#,#,#,#,#,#,#,#,#,#,#,#, , , , , , , , , ,#,#,#,#,#,#,#,#,#,#,#,#,#,#,#,#,
#,#, , , , , ,#,#,#,#,#,#,#,#,#,#,#,#,#,#,#,#,#,#,#, , , , , , , , ,#,#,#,#,#,#,#,#,#,#,#,#,#,#,#,#,
#,#, , , , ,#,#,#,#,#,#,#,#,#,#,#,#,#,#,#,#,#,#,#,#,#, , , , , , , ,#,#,#,#,#,#,#,#,#,#,#,#,#,#,#,#,
#,#,#, , ,#,#,#,#,#,#,#,#,#,#,#,#,#,#,#,#,#,#,#,#,#,#,#, , , , , , ,#,#,#,#,#,#,#,#,#,#,#,#,#,#,#,#,
#,#,#,#,#,#,#,#,#,#,#,#,#,#,#,#,#,#,#,#,#,#,#,#,#,#,#,#, , , , , , ,#,#,#,#,#,#,#,#,#,#,#,#,#,#,#,#,
#,#,#,#,#,#,#,#,#,#,#,#,#,#,#,#,#,#,#,#,#,#,#,#,#,#,#,#, , , , , , ,#,#,#,#,#,#,#,#,#,#,#,#,#,#,#,#,
#,#,#,#,#,#,#,#,#,#,#,#,#,#, , ,#,#,#,#,#,#,#,#,#,#,#,#,#, , , , , ,#,#,#,#,#, , , , , , , ,#,#,#,#,
#,#,#,#,#,#,#,#,#,#,#,#,#, , , ,#,#,#,#,#,#,#,#,#,#,#,#,#,#,#, , , ,#,#,#,#, , , , , , , , , ,#,#,#,
#,#,#,#,#,#,#,#,#,#,#,#, , , ,#,#,#,#,#,#,#,#,#,#,#,#,#,#,#,#,#, , , ,#,#, , , , ,#,#,#,#, , , ,#,#,
#,#,#,#,#, , , ,#,#,#, , , , ,#,#,#,#,#,#,#,#,#,#,#,#,#,#,#,#,#,#, , , , , , , ,#,#,#,#,#,#, , , ,#,
#,#,#, , , , , , , , , , , , ,#,#,#,#,#,#,#,#,#,#,#,#,#,#,#,#,#,#, , , , , , , ,#,#,#,#,#,#, , , ,#,
#,#, , , , , , , , , , , , , ,#,#,#,#,#,#, , , , ,#,#,#,#,#,#,#,#,#, , , , , , ,#,#,#,#,#,#, , ,#,#,
#,#, , ,#,#,#,#, , , , ,#, , , ,#,#,#, , , , , , , ,#,#,#,#,#,#,#,#, , , , , , , ,#,#,#,#, , , ,#,#,
#, , ,#,#,#,#,#,#, , , , , , , , , , , , , , , , , , ,#,#,#,#,#,#,#, , , , , , , , , , , , , ,#,#,#,
#, , ,#,#,#,#,#,#, , , , , , , , , , , , , ,#,#, , , , ,#,#,#,#,#, , , ,#,#,#, , , , , , , ,#,#,#,#,
#, , ,#,#,#,#,#, , , , ,#,#,#,#, , , , , ,#,#,#,#, , , , , , , , , , ,#,#,#,#,#,#,#, , , ,#,#,#,#,#,
#,#, , ,#,#,#, , , , ,#,#,#,#,#,#, , , ,#,#,#,#,#,#, , , , , , , , , ,#,#,#,#,#,#,#,#,#,#,#,#,#,#,#,
#,#,#, , , , , , , ,#,#,#,#,#,#,#, , , ,#,#,#,#,#,#,#,#,#,#, , , , , , ,#,#,#,#,#,#,#,#,#,#,#,#,#,#,
#,#,#, , , , , , , ,#,#,#,#,#,#,#, , , ,#,#,#,#,#,#,#,#,#,#,#, , , , , , ,#,#,#,#,#,#,#,#,#,#,#,#,#,
#,#,#,#, , , , , , , ,#,#,#,#,#,#,#,#,#,#,#,#,#,#,#,#,#,#,#,#,#, , ,#,#, , ,#,#,#,#,#,#,#,#,#,#,#,#,
#,#,#,#,#,#, , , , , , ,#,#,#,#,#,#,#,#,#,#,#,#,#,#,#,#,#,#,#,#, , ,#, , , ,#,#,#,#,#,#,#,#,#,#,#,#,
#,#,#,#,#,#,#,#, , , , ,#,#,#,#,#,#,#,#,#,#,#,#,#,#,#,#,#,#,#,#, , , , , , ,#,#,#,#,#,#,#,#,#,#,#,#,
#,#,#,#,#,#,#,#,#, , , , ,#,#,#,#,#,#,#,#,#,#,#,#,#,#,#,#,#,#,#,#, , , , , , ,#,#,#,#,#,#,#,#,#,#,#,
#,#,#,#,#,#,#,#,#, , , , , , ,#,#,#,#,#,#,#,#,#,#,#,#,#,#,#,#,#,#, , , , , , , , , ,#,#,#,#,#,#,#,#,
#,#,#,#,#,#,#,#, , , , , , , , , ,#,#,#,#,#,#,#,#,#,#,#,#,#,#,#, , , , , , , , , , , ,#,#,#,#,#,#,#,
#,#,#,#,#,#,#,#, , , ,#,#,#, , , , , ,#,#,#,#,#,#,#,#,#,#,#,#, , , , , ,#,#,#, , , , ,#,#,#,#,#,#,#,
#,#,#,#,#,#,#, , , ,#,#,#,#,#,#, , , , ,#,#,#,#,#,#,#,#,#,#,#, , , , ,#,#,#,#,#, , , ,#,#,#,#,#,#,#,
#,#,#,#,#,#, , , , ,#,#,#,#,#,#,#, , , , ,#,#,#,#,#,#,#,#,#,#, , , , ,#,#,#,#,#, , , ,#,#,#,#,#,#,#,
#,#,#,#,#, , , , , ,#,#,#,#,#,#,#, , , , ,#,#,#,#,#,#,#,#,#,#,#, , , ,#,#,#,#, , , ,#,#,#,#,#,#,#,#,
#,#,#,#,#,#, , , , , ,#,#,#,#,#, , , , , , ,#,#,#,#,#,#,#,#,#,#,#, , , ,#,#, , , ,#,#,#,#,#,#,#,#,#,
#,#,#,#,#,#,#,#, , , ,#,#,#,#, , , , , , , , ,#,#,#,#,#,#,#,#,#,#, , , , , , , , ,#,#,#,#,#,#,#,#,#,
#,#,#,#,#,#,#,#,#, , ,#,#,#,#, , ,#,#,#, , ,#,#,#,#,#,#,#,#,#,#,#,#, , , , , , , ,#,#,#,#,#,#,#,#,#,
#,#,#,#,#,#,#,#,#,#, , ,#,#, , ,#,#,#,#,#,#,#,#,#,#,#,#,#,#,#,#,#,#,#,#,#,#, , ,#,#,#,#,#,#,#,#,#,#,
#,#,#,#,#,#,#,#,#,#, , , , , ,#,#,#,#,#,#,#,#,#,#,#,#,#,#,#,#,#,#,#,#,#,#,#,#,#,#,#,#,#,#,#,#,#,#,#,
#,#,#,#,#,#,#,#,#,#,#, , , ,#,#,#,#,#,#,#,#,#,#,#,#,#,#,#,#,#,#,#,#,#,#,#,#,#,#,#,#,#,#,#,#,#,#,#,#,
#,#,#,#,#,#,#,#,#,#,#,#,#,#,#,#,#,#,#,#,#,#,#,#,#,#,#,#,#,#,#,#,#,#,#,#,#,#,#,#,#,#,#,#,#,#,#,#,#,#,
