#,#,#,#,#,#,#,#,#,#,#,#,#,#,#,#,#,#,#,#,#,#,#,#,#,#,#,#,#,#,#,#,#,#,#,#,#,#,#,#,#,#,#,#,#,#,#,#,#,#,
#,#,#,#,#,#,#,#,#,#,#,#,#,#,#,#,#,#,#,#,#,#,#,#,#,#,#,#,#,#,#,#,#,#,#,#,#,#,#,#,#,#,#,#,#,#,#,#,#,#,
#,#, , ,#,#,#,#,#,#,#,#,#,#,#,#,#,#,#,#,#,#,#,#,#,#,#,#,#,#,#,#,#, , , , , , , , , , ,#,#,#,#,#,#,#,
#, , , , ,#,#,#,#,#,#,#,#,#,#,#,#,#,#,#,#,#,#,#,#,#,#,#,#,#,#,#, , , , , , , , , , , ,#,#,#,#,#,#,#,
#, , , ,#,#,#,#,#,#,#,#,#,#,#,#,#,#,#,#,#,#,#,#, , ,#,#,#,#,#,#, , , , , , , , ,#,#,#,#,#,#,#,#,#,#,
#, , , ,#,#,#,#,#,#,#, , , ,#,#,#,#,#,#,#,#, , , , , ,#,#,#,#,#,#, , , , , , ,#,#,#,#,#,#,#,#,#,#,#,
#, , , ,#,#,#,#,#,#,#, , , ,#,#,#,#,#,#,#, , , ,#,#, , ,#,#,#,#,#, , , , , ,#,#,#,#,#,#,#,#,#,#,#,#,
#,#, , ,#,#,#,#,#,#, , , ,#,#,#,#,#,#,#, , ,#,#,#,#,#, , ,#,#,#, , , , , ,#,#,#,#,#,#,#,#,#,#,#,#,#,
#,#, , , ,#,#,#,#,#, , , ,#,#,#,#,#, , , ,#,#,#,#,#,#, , , , , , , , , , ,#,#,#,#,#,#,#,#,#,#,#,#,#,
#,#, , , ,#,#,#,#,#, , , , ,#,#,#, , , ,#,#,#,#,#,#,#, , , , , , , , , , , ,#,#,#,#,#, , , ,#,#,#,#,
#,#, , , ,#,#,#,#,#,#, , , , , , , , ,#,#,#,#,#,#,#,#, , , , , , , ,#,#, , , ,#,#,#,#, , , ,#,#,#,#,
#,#,#, , , ,#,#,#,#,#, , , , , , , , ,#,#,#,#,#,#,#,#, , , , , , ,#,#,#,#, , , ,#,#, , , , ,#,#,#,#,
#,#,#, , , ,#,#,#,#,#,#, , , , , , , , ,#,#,#,#,#,#, , , , , , ,#,#,#,#,#,#, , , , , , , ,#,#,#,#,#,
#,#,#,#, , , ,#,#,#,#,#,#, , , , , , , , , , ,#,#, , , , , ,#,#,#,#,#,#,#,#,#, , , , , ,#,#,#,#,#,#,
#,#,#,#, , , ,#,#,#,#,#,#, , , , , , , , , , , , , , , , ,#,#,#,#,#,#,#,#,#,#, , , , ,#,#,#,#,#,#,#,
#,#,#,#, , , ,#,#,#,#,#,#, , , , , , , , , , , , , , , , ,#,#,#,#,#,#,#,#,#,#,#, , ,#,#,#,#,#,#,#,#,
#,#,#,#, , , ,#,#,#,#,#, , , , , , , , ,#,#, , , , , , , ,#,#,#,#,#,#,#,#,#,#,#,#,#,#,#,#,#,#,#,#,#,
#,#,#,#,#, , , ,#,#,#,#, , , , , , , ,#,#,#,#,#,#,#, , , , ,#,#,#,#,#,#,#,#,#,#,#,#,#,#,#,#,#,#,#,#,
#,#,#,#,#,#, , , ,#,#,#, , , , , , , ,#,#,#,#,#,#,#,#, , ,#,#,#,#,#,#,#,#,#,#,#,#,#,#,#,#,#,#,#,#,#,
#,#,#,#,#,#,#, , , ,#,#, , , , , , , ,#,#,#,#,#,#,#,#,#,#,#,#,#,#,#,#,#,#,#,#,#,#,#,#,#,#,#,#,#,#,#,
#,#,#,#,#,#,#,#, , ,#,#, , , , , , , ,#,#,#,#,#,#,#,#,#,#,#,#,#,#,#,#,#,#,#,#,#,#,#,#,#,#,#,#,#,#,#,
#,#,#,#,#,#,#,#, , ,#,#, , , , , , ,#,#,#,#,#,#,#,#,#,#,#,#,#,#,#,#,#,#,#,#, , , , , , ,#,#,#,#,#,#,
#,#, , ,#,#,#, , , ,#,#, , , , , ,#,#,#,#,#,#,#,#,#,#,#,#,#,#,#,#,#,#,#,#, , , , , , , ,#,#,#,#,#,#,
#, , , , , , , , , ,#,#,#, , , , ,#,#,#,#,#,#,#,#,#,#,#,#,#,#,#,#,#,#,#, , , , , , , , ,#,#,#,#,#,#,
#, , , , , , , , ,#,#,#,#,#, , , , ,#,#,#,#,#,#,#,#,#,#,#,#,#,#,#,#,#, , , ,#,#,#, , , ,#,#,#,#,#,#,
#, , , , , , , , ,#,#,#,#,#,#, , , , ,#,#,#,#,#,#,#,#,#,#,#,#,#,#,#,#, , ,#,#,#,#,#, , ,#,#,#,#,#,#,
#, , , , , , , , ,#,#,#,#,#,#,#, , , ,#,#,#,#, , ,#,#,#,#,#,#,#,#,#,#, , ,#,#,#,#,#, , ,#,#,#,#,#,#,
#, , , , , , , , ,#,#,#,#,#,#,#,#, , , ,#,#, , , , ,#,#,#,#,#,#,#,#,#,#, ,#,#,#,#,#, , , ,#,#,#,#,#,
#, , , , , , , , , ,#,#,#,#,#,#,#, , , , , , , , , ,#,#,#,#,#,#,#,#,#,#, , ,#,#,#,#, , , ,#,#,#,#,#,
#, , , , , , , , , , ,#,#,#,#,#,#, , , , , , , , , ,#,#,#,#,#,#,#,#,#,#, , , ,#,#, , , , ,#,#,#,#,#,
#, , , , , , , , , , , ,#,#,#,#, , , , ,#,#,#,#, , ,#,#,#,#,#,#,#,#,#,#,#, , , , , , , , ,#,#,#,#,#,
#,#, , , ,#,#,#, , , , ,#,#,#, , , , ,#,#,#,#,#,#, , ,#,#,#,#,#,#,#,#,#,#, , , , , , , ,#,#,#,#,#,#,
#,#,#,#,#,#,#,#,#, , , , , , , , , , ,#,#,#,#,#,#,#, , ,#,#,#,#,#,#,#,#, , ,#,#, , , ,#,#,#,#,#,#,#,
#,#,#,#,#,#,#,#,#, , , , , , , , , , , ,#,#,#,#,#,#, , , , , ,#,#,#, , , ,#,#,#,#, , ,#,#,#,#,#,#,#,
#,#,#,#,#,#,#,#, , ,#,#, , , , , , , , , ,#,#,#,#, , , , , , , , , , , ,#,#,#,#,#, , , ,#,#,#,#,#,#,
#,#,#,#,#,#,#, , ,#,#,#, , , , , , , , , , , , , , , , , , , , , , , , ,#,#,#,#,#, , , ,#,#,#,#,#,#,
#,#,#,#,#,#, , , ,#,#,#,#, , , , , , ,#,#, , , , , , , , , , , , , , , , ,#,#,#,#, , ,#,#,#,#,#,#,#,
#,#,#,#,#,#, , ,#,#,#,#,#,#,#,#,#,#,#,#,#,#,#,#, , , , , , , , , , , , , , ,#,#, , ,#,#,#,#,#,#,#,#,
#,#,#,#,#, , , ,#,#,#,#,#,#,#,#,#,#,#,#,#,#,#,#,#, , , , , , , ,#,#,#,#,#, , , , ,#,#,#,#,#,#,#,#,#,
#,#,#,#, , , ,#,#,#,#,#,#,#,#,#,#,#,#,#,#,#,#,#,#,#, , , , , , ,#,#,#,#,#,#, , ,#,#,#,#,#,#,#,#,#,#,
#,#,#,#, , ,#,#,#,#,#,#,#, ,#,#,#,#,#,#,#,#,#,#,#,#,#, , , , , ,#,#,#,#,#,#,#, ,#,#,#,#,#,#,#,#,#,#,
#,#,#,#, , ,#,#,#,#,#,#, , , ,#,#,#,#,#,#,#,#,#,#,#,#,#,#,#, , , ,#,#,#,#,#,#, , ,#,#,#,#,#,#,#,#,#,
#,#,#,#,#, , ,#,#,#,#,#,#, , ,#,#,#,#,#,#,#,#,#,#,#,#,#,#,#,#, , , ,#,#,#,#,#, , , ,#,#,#,#,#,#,#,#,
#,#,#,#,#, , ,#,#,#,#,#,#, , ,#,#,#,#,#,#,#,#,#,#,#,#,#,#,#,#, , , ,#,#,#,#,#, , , ,#,#,#,#,#,#,#,#,
#,#,#,#,#, , , ,#,#,#,#, , ,#,#,#,#,#,#,#,#,#,#,#,#,#,#,#,#,#, , , , ,#,#,#,#, , , ,#,#,#,#,#,#,#,#,
#,#,#,#,#,#, , , , , , , , ,#,#,#,#,#,#,#,#,#,#,#,#,#,#,#,#,#,#, , , , ,#,#, , , ,#,#,#,#,#,#,#,#,#,
#,#,#,#,#,#,#,#, , , , , ,#,#,#,#,#,#,#,#,#,#,#,#,#,#,#,#,#,#,#,#,#, , , , , , , ,#,#,#,#,#,#,#,#,#,
#,#,#,#,#,#,#,#,#,#,#,#,#,#,#,#,#,#,#,#,#,#,#,#,#,#,#,#,#,#,#,#,#,#,#, , , , , ,#,#,#,#,#,#,#,#,#,#,
#,#,#,#,#,#,#,#,#,#,#,#,#,#,#,#,#,#,#,#,#,#,#,#,#,#,#,#,#,#,#,#,#,#,#,#,#,#,#,#,#,#,#,#,#,#,#,#,#,#,
#,#,#,#,#,#,#,#,#,#,#,#,#,#,#,#,#,#,#,#,#,#,#,#,#,#,#,#,#,#,#,#,#,#,#,#,#,#,#,#,#,#,#,#,#,#,#,#,#,#,
