#,#,#,#,#,#,#,#,#,#,#,#,#,#,#,#,#,#,#,#,#,#,#,#,#,#,#,#,#,#,#,#,#,#,#,#,#,#,#,#,#,#,#,#,#,#,#,#,#,#,
#,#,#,#,#,#,#,#,#,#,#,#,#,#,#,#,#,#, , , , , , ,#,#,#,#,#,#,#,#,#,#,#,#,#, , , , , , , , ,#,#,#,#,#,
#,#,#,#,#,#,#,#,#,#,#,#,#,#,#,#,#, , , , , , , , ,#,#,#,#,#,#,#,#,#,#,#, , , , , , , , , , ,#,#,#,#,
#,#,#,#,#,#,#,#,#,#,#,#,#,#,#, , , , ,#,#,#, , , ,#,#,#,#,#,#,#,#,#,#,#, , , ,#,#,#, , , , ,#,#,#,#,
#,#, , , , , , , , ,#,#,#,#, , , , ,#,#,#,#,#, , ,#,#,#,#,#,#,#,#,#,#,#, , ,#,#,#,#,#, , ,#,#,#,#,#,
#, , , , , , , , , , , , , , , , ,#,#,#,#,#,#, , , ,#,#,#,#,#,#,#,#,#,#, , ,#,#,#,#,#, , ,#,#,#,#,#,
#, , , , , , , , , , , , , , , , ,#,#,#,#,#,#, , , , ,#,#,#,#,#,#,#,#,#, , , ,#,#,#, , , ,#,#,#,#,#,
#, , , ,#,#,#,#,#, , , , , , , , , ,#,#,#,#, , , , , , , ,#,#,#,#,#,#, , , , , , , , , ,#,#,#,#,#,#,
#, , ,#,#,#,#,#,#,#, , , , , , , , , , , , , , , , , , , , ,#,#,#,#, , , , , , , , , ,#,#,#,#,#,#,#,
#, , ,#,#,#,#,#,#,#, , , , , , , , , , , , , , , , , , , , , , , , , , , , , , , , ,#,#,#,#,#,#,#,#,
#, , ,#,#,#,#,#,#, , , ,#,#,#,#,#, , ,#,#,#, , , , , ,#,#,#, , , , , , , , , ,#,#,#,#,#,#,#,#,#,#,#,
#, , , ,#,#,#, , , , ,#,#,#,#,#,#,#,#,#,#,#,#, , , ,#,#,#,#,#,#,#, , , , , ,#,#,#,#,#,#,#,#,#,#,#,#,
#,#, , , , , , , , ,#,#,#,#,#,#,#,#,#,#,#,#,#,#,#,#,#,#,#,#,#,#,#,#, , , , ,#,#,#,#,#,#,#,#,#,#,#,#,
#,#,#, , , , , , ,#,#,#,#,#,#,#,#,#,#,#,#,#,#,#,#,#,#,#,#,#,#,#,#,#,#, , , ,#,#,#,#,#,#,#,#,#,#,#,#,
#,#,#,#,#,#,#,#,#,#,#,#,#,#,#,#,#,#,#,#,#,#,#,#,#,#,#,#,#,#,#,#,#,#,#, , , ,#,#,#,#,#,#,#,#,#,#,#,#,
#,#,#,#,#,#,#,#,#,#,#,#,#,#,#,#,#,#,#,#,#,#, , ,#,#,#,#,#,#,#,#,#,#, , , , , ,#,#, , , , ,#,#,#,#,#,
#,#,#,#,#,#,#,#,#,#,#,#,#,#,#,#,#, , , , , , , , , ,#,#,#,#,#,#,#, , , , , , , , , , , , , ,#,#,#,#,
#,#,#,#,#,#,#,#,#,#,#,#,#,#,#,#, , , , , , , , , , , , , , , , , , , , , , , , , ,#,#,#, , , ,#,#,#,
#,#,#,#,#,#,#,#,#,#,#,#,#, , , , , , , , , , , , , , , , , , , , , , , , , , , ,#,#,#,#,#, , , ,#,#,
#,#,#,#,#,#,#,#,#,#,#,#, , , , ,#,#,#,#, , , , , , , ,#,#,#,#,#,#,#, , , , , , ,#,#,#,#,#,#, , ,#,#,
#,#,#,#,#,#,#,#,#,#,#,#, , , ,#,#,#,#,#,#, , , , , ,#,#,#,#,#,#,#,#,#,#, , , , ,#,#,#,#,#,#, , ,#,#,
#,#,#,#,#,#,#,#,#,#,#,#, , ,#,#,#,#,#,#,#, , , , ,#,#,#,#,#,#,#,#,#,#,#,#,#, , , ,#,#,#,#,#, , ,#,#,
#,#,#,#,#,#,#,#,#,#,#,#, , ,#,#,#,#,#,#,#, , , ,#,#,#,#,#,#,#,#,#,#,#,#,#,#,#, , ,#,#,#,#,#, , ,#,#,
#,#,#,#,#,#,#,#,#,#,#,#, , ,#,#,#,#,#,#,#, , , ,#,#,#,#,#,#,#,#,#,#,#,#,#,#,#,#, , ,#,#,#, , , ,#,#,
#,#,#,#,#,#,#,#,#,#,#, , , ,#,#,#,#,#,#,#, , , , ,#,#,#,#,#,#,#,#,#,#,#,#,#,#,#,#, , , , , , , ,#,#,
#,#,#,#,#, , ,#,#, , , , , ,#,#, , , ,#, , , , , , , , , , , , ,#,#,#,#,#,#,#,#,#,#, , , , , ,#,#,#,
#,#,#,#, , , , , , , , , , , , , , , , , , , , , , , , , , , , , ,#,#,#,#,#,#,#,#,#,#, , , ,#,#,#,#,
#,#,#,#, , , , , , , , , , , , , , , , , , , , , , , , , , , , , , , ,#,#,#,#,#,#,#,#,#,#,#,#,#,#,#,
#,#,#,#,#, , , , , , , , , , , , , , , , , , , , , , ,#,#, , , , , , , ,#,#,#,#,#,#,#,#,#,#,#,#,#,#,
#,#,#,#,#,#,#, , , , , , , ,#,#,#,#,#,#,#,#, , , , ,#,#,#,#,#,#, , , , ,#,#,#,#,#,#,#,#,#,#,#,#,#,#,
#,#,#,#,#,#,#,#, , , ,#,#,#,#,#,#,#,#,#,#,#,#, , , ,#,#,#,#,#,#,#, , ,#,#,#,#,#,#,#,#,#,#,#,#,#,#,#,
#,#,#,#,#,#,#,#, , , ,#,#,#,#,#,#,#,#,#,#,#,#,#, , ,#,#,#,#,#,#,#,#,#,#,#,#,#,#,#,#,#,#,#,#,#,#,#,#,
#,#,#,#,#,#,#,#,#, , , , ,#,#,#,#,#,#,#,#,#,#,#, , ,#,#,#,#,#,#,#,#,#,#,#,#,#,#,#,#,#,#,#,#,#,#,#,#,
#,#,#,#,#,#,#,#,#, , , , ,#,#,#,#,#,#,#,#,#,#,#, , ,#,#,#,#,#,#,#,#,#,#,#,#,#,#, , , ,#,#,#,#,#,#,#,
#,#, , ,#,#,#,#,#, , , , ,#,#,#,#,#,#,#,#,#,#,#, , , ,#,#,#,#, , , , , , , , , , , , , ,#,#,#,#,#,#,
#,#, , , , ,#,#, , , , , , ,#,#,#,#,#,#,#,#,#,#,#, , , , , , , , , , , , , , , , , , , ,#,#,#,#,#,#,
#,#,#, , , , , , , , , , , , , , ,#,#,#,#,#,#,#,#,#, , , , , , , , , , , , , , ,#,#, , , ,#,#,#,#,#,
#,#,#,#, , , , , , , , , , , , , , ,#,#,#,#,#,#,#,#,#, , ,#,#, , , , , , , , ,#,#,#,#, , , ,#,#,#,#,
#,#,#,#,#,#, , , , , , , , , , , , , ,#,#,#,#,#,#,#,#,#,#,#,#,#, , , , , , ,#,#,#,#,#,#, , , ,#,#,#,
#,#,#,#,#,#,#,#,#, , , , , , , , , , , ,#,#,#,#,#,#,#,#,#,#,#,#, , , , , , ,#,#,#,#,#,#, , , ,#,#,#,
#,#,#,#,#,#,#,#,#,#, , , , ,#,#,#,#, , , ,#,#,#,#,#,#,#,#,#,#,#,#, , , , , ,#,#,#,#,#,#, , , ,#,#,#,
#,#,#,#,#,#,#,#,#,#,#, , ,#,#,#,#,#,#, , ,#,#,#,#,#,#,#,#,#,#,#,#,#, , , , ,#,#,#,#,#,#, , ,#,#,#,#,
#,#,#,#,#,#,#,#,#,#,#, , ,#,#,#,#,#,#,#, , ,#,#,#,#,#,#,#,#,#,#,#,#,#, , , , ,#,#,#,#, , , ,#,#,#,#,
#,#,#,#,#,#,#,#,#,#,#, , ,#,#,#,#,#,#,#, , , ,#,#,#,#,#,#,#,#,#,#,#,#, , , , , , , , , , ,#,#,#,#,#,
#,#,#,#,#,#,#,#,#,#,#, , , ,#,#,#,#,#,#, , , , ,#,#,#,#,#,#,#,#,#,#,#, , , , , , , , , ,#,#,#,#,#,#,
#,#,#,#,#,#,#,#,#,#,#,#, , , ,#,#,#,#, , , , , ,#,#,#,#,#,#,#,#,#,#,#,#, , , , , , , ,#,#,#,#,#,#,#,
#,#,#,#,#,#,#,#,#,#,#,#, , , , , , , , , , , ,#,#,#,#,#,#,#,#,#,#,#,#,#,#,#,#,#, , ,#,#,#,#,#,#,#,#,
#,#,#,#,#,#,#,#,#,#,#,#,#, , , , , , , ,#,#,#,#,#,#,#,#,#,#,#,#,#,#,#,#,#,#,#,#,#,#,#,#,#,#,#,#,#,#,
#,#,#,#,#,#,#,#,#,#,#,#,#,#,#,#,#,#,#,#,#,#,#,#,#,#,#,#,#,#,#,#,#,#,#,#,#,#,#,#,#,#,#,#,#,#,#,#,#,#,
#,#,#,#,#,#,#,#,#,#,#,#,#,#,#,#,#,#,#,#,#,#,#,#,#,#,#,#,#,#,#,#,#,#,#,#,#,#,#,#,#,#,#,#,#,#,#,#,#,#,
