#,#,#,#,#,#,#,#,#,#,#,#,#,#,#,#,#,#,#,#,#,#,#,#,#,#,#,#,#,#,#,#,#,#,#,#,#,#,#,#,#,#,#,#,#,#,#,#,#,#,
#,#,#,#,#,#,#,#,#,#,#,#,#,#,#,#,#,#,#,#,#,#,#,#,#,#,#,#,#,#,#,#,#,#,#,#,#,#,#, , , , , , , ,#,#,#,#,
#,#,#,#,#,#,#,#,#,#,#,#,#,#,#,#,#,#,#, , , , , , ,#,#,#,#,#,#,#,#,#,#,#,#,#, , , , , , , , , ,#,#,#,
#,#,#,#, , , ,#,#,#,#,#,#,#,#,#,#,#, , , , , , , , ,#,#,#,#,#,#,#,#, , , , , , , ,#,#,#,#,#, , ,#,#,
#,#,#, , , , , , , ,#,#,#,#,#,#,#,#, , , , ,#,#, , ,#,#,#,#,#,#,#, , , , , , , ,#,#,#,#,#,#,#, , ,#,
#,#,#, , , , , , , , ,#,#,#,#,#,#,#, , , ,#,#,#,#, , ,#,#,#,#,#, , , , , , , , ,#,#,#,#,#,#,#, , ,#,
#,#,#, , ,#,#,#, , , ,#,#,#,#,#,#, , , ,#,#,#,#,#, , , , , , , , , , , , , , , , ,#,#,#,#,#,#, , ,#,
#,#, , ,#,#,#,#,#, , , ,#,#,#,#,#, , ,#,#,#,#,#,#, , , , , , , , , , , , , , , , , , ,#,#,#, , ,#,#,
#,#, , ,#,#,#,#,#, , , ,#,#,#,#,#, , ,#,#,#,#,#, , , , , , ,#,#,#,#,#,#,#, , , , , , , , , , ,#,#,#,
#,#, , ,#,#,#,#,#, , ,#,#,#,#,#,#, , , ,#,#, , , , , , , ,#,#,#,#,#,#,#,#,#, , , ,#,#, , , ,#,#,#,#,
#,#, , , ,#,#,#, , , ,#,#,#,#,#,#, , , , , , , ,#, , , , ,#,#,#,#,#,#,#,#,#, , ,#,#,#,#,#,#,#,#,#,#,
#,#,#, , , , , , , , , ,#,#,#,#,#, , , , , , ,#,#,#, , , , ,#,#,#,#,#,#,#, , , ,#,#,#,#,#,#,#,#,#,#,
#,#,#,#, , , , , , , , , , ,#,#, , , , , , , , ,#, , , , , , ,#,#,#,#,#, , , , ,#,#,#,#,#,#,#,#,#,#,
#,#,#,#,#, , , , , , , , , , , , , , , , , , , , , , , , , , , ,#,#,#, , , , , , ,#,#,#,#,#,#,#,#,#,
#,#,#,#,#,#,#,#, , , , , , , , , , , , , , , , , , , ,#,#, , , , , , , , , , , , ,#,#,#,#,#,#,#,#,#,
#,#,#,#,#,#,#,#,#, , , , , , , , , , , , , , ,#,#,#,#,#,#,#, , , , , , , , , , , , ,#,#,#,#,#,#,#,#,
#,#,#,#,#,#,#,#,#, , , , ,#,#,#,#, , , , , ,#,#,#,#,#,#,#,#, , , , , , , , , , , , , ,#,#,#,#,#,#,#,
#,#,#,#,#,#,#,#,#, , , ,#,#,#,#,#,#, , , ,#,#,#,#,#,#,#,#,#,#, , , , , , , , , , , , , , , , ,#,#,#,
#,#,#,#,#,#,#,#,#,#, , ,#,#,#,#,#,#, , , ,#,#,#,#,#,#,#,#,#,#,#, , , , , , , ,#,#,#,#, , , , , ,#,#,
#,#,#,#,#,#,#,#,#,#, , ,#,#,#,#,#,#, , , , ,#,#,#,#,#,#,#,#,#,#,#, , , , , , ,#,#,#,#,#,#,#, , , ,#,
#,#,#,#,#,#,#,#,#,#, , ,#,#,#,#,#,#, , , , , , ,#,#,#,#,#,#,#,#, , , , , , , ,#,#,#,#,#,#,#,#, , ,#,
#,#,#,#,#,#,#,#,#,#, , ,#,#,#,#,#,#, , , , , , , ,#,#,#, , , , , , , , , , , ,#,#,#,#,#,#,#,#, , ,#,
#,#,#,#,#,#,#,#,#,#, , ,#,#,#,#,#, , , , , , , , ,#,#, , , , , , , , , , , , ,#,#,#,#,#,#,#,#, ,#,#,
#,#,#,#,#,#,#,#,#,#, , , ,#,#,#, , , , ,#, , , ,#,#,#, , ,#,#,#,#, , , , , , ,#,#,#,#,#,#,#, , ,#,#,
#,#,#,#,#,#,#,#,#, , , , , , , , , , , ,#,#,#,#,#,#, , ,#,#,#,#,#,#, , , , , , ,#,#,#,#,#, , , ,#,#,
#,#,#,#,#,#,#,#, , , ,#, , , , , , , , ,#,#,#,#,#, , , ,#,#,#,#,#,#, , , , , , , , ,#,#, , , ,#,#,#,
#,#,#,#,#,#,#, , , ,#,#,#, , , , , , ,#,#,#,#,#,#, , , ,#,#,#,#,#, , , , , , , , , , , , ,#,#,#,#,#,
#,#,#,#,#,#,#, , , ,#,#,#, , ,#,#,#,#,#,#,#,#,#,#, , , , ,#,#,#, , , , , ,#,#,#, , , , ,#,#,#,#,#,#,
#,#,#,#,#,#,#,#, , ,#,#, , ,#,#,#,#,#,#,#,#,#,#,#,#, , , , , , , , , , , ,#,#,#,#,#,#,#,#,#,#,#,#,#,
#,#,#,#,#,#,#,#, , , , , ,#,#,#,#,#,#,#,#,#,#,#,#,#,#,#, , , , , , , , , ,#,#,#,#,#,#,#,#,#,#,#,#,#,
#,#,#, , ,#,#, , , , , ,#,#,#,#,#,#,#,#,#,#,#,#,#,#,#,#,#,#,#, , , , , , ,#,#,#,#,#,#,#,#,#,#,#,#,#,
#,#, , , , , , , , , ,#,#,#,#,#,#,#,#,#,#,#,#,#,#,#,#,#,#,#,#,#,#,#,#, , , ,#,#,#,#,#,#,#,#,#,#,#,#,
#,#,#, , , , , , , , ,#,#,#,#,#,#,#,#,#,#,#,#,#,#,#,#,#,#,#,#,#,#,#,#,#, , ,#,#,#,#,#,#,#,#,#,#,#,#,
#,#,#,#,#,#,#,#, , , , ,#,#,#,#,#,#,#,#,#,#,#,#,#,#,#,#,#,#,#,#,#,#,#,#, , ,#,#,#,#,#,#,#,#,#,#,#,#,
#,#,#,#,#,#,#,#,#, , , ,#,#,#,#,#,#,#,#,#,#,#,#,#,#,#,#,#,#,#,#,#,#,#,#, , , ,#,#,#,#,#,#,#,#,#,#,#,
#,#,#,#,#,#,#,#,#, , , ,#,#,#,#,#,#,#,#,#,#,#,#,#,#,#,#,#,#,#,#, , , , , , , , , ,#,#,#,#,#,#,#,#,#,
#,#,#,#,#,#,#,#,#, , , , ,#,#,#,#,#,#,#,#,#,#,#,#,#,#,#,#,#,#,#, , , , , , , , , , ,#,#,#,#,#,#,#,#,
#,#,#,#,#,#,#,#,#,#, , , , , , , , , , , ,#,#,#,#,#,#,#,#,#,#,#,#,#, , , , ,#,#, , ,#,#,#,#,#,#,#,#,
#,#,#,#, , ,#,#,#, , ,#, , , , , , , , , , ,#,#,#,#,#,#,#,#,#,#,#,#,#, , ,#,#,#,#, , ,#,#,#,#,#,#,#,
#,#,#,#, , , ,#,#, , ,#,#,#,#,#,#,#,#,#,#, , ,#,#,#,#,#,#,#,#,#,#,#,#,#,#,#,#,#,#,#, , ,#,#,#,#,#,#,
#,#,#,#,#, , , , , ,#,#,#,#,#,#,#,#,#,#,#,#, , , ,#,#,#,#,#,#,#,#,#,#,#,#,#,#,#,#,#, , ,#,#,#,#,#,#,
#,#,#,#,#,#, , , , ,#,#,#,#,#,#,#,#,#,#,#,#, , , , ,#,#,#,#,#,#,#,#,#,#,#,#,#,#,#,#, , ,#,#,#,#,#,#,
#,#,#,#,#,#,#, , , ,#,#,#,#,#,#,#,#,#,#,#,#, , , , ,#,#,#,#,#,#,#,#,#,#,#,#,#,#,#, , ,#,#,#,#,#,#,#,
#,#,#,#,#,#,#,#, ,#,#,#,#,#,#,#,#, ,#,#,#, , , , ,#,#,#,#,#,#,#,#,#,#,#,#,#,#, , , ,#,#,#,#,#,#,#,#,
#,#,#,#,#,#,#,#,#,#,#,#,#,#,#,#, , , , , , ,#,#,#,#,#,#,#,#,#,#,#,#,#,#,#,#,#, , ,#,#,#,#,#,#,#,#,#,
#,#,#,#,#,#,#,#,#,#,#,#,#,#,#,#, , , , , ,#,#,#,#,#,#,#,#,#,#,#,#,#,#,#,#,#,#,#,#,#,#,#,#,#,#,#,#,#,
#,#,#,#,#,#,#,#,#,#,#,#,#,#,#,#,#, , , ,#,#,#,#,#,#,#,#,#,#,#,#,#,#,#,#,#,#,#,#,#,#,#,#,#,#,#,#,#,#,
#,#,#,#,#,#,#,#,#,#,#,#,#,#,#,#,#,#,#,#,#,#,#,#,#,#,#,#,#,#,#,#,#,#,#,#,#,#,#,#,#,#,#,#,#,#,#,#,#,#,
#,#,#,#,#,#,#,#,#,#,#,#,#,#,#,#,#,#,#,#,#,#,#,#,#,#,#,#,#,#,#,#,#,#,#,#,#,#,#,#,#,#,#,#,#,#,#,#,#,#,
#,#,#,#,#,#,#,#,#,#,#,#,#,#,#,#,#,#,#,#,#,#,#,#,#,#,#,#,#,#,#,#,#,#,#,#,#,#,#,#,#,#,#,#,#,#,#,#,#,#,
