#,#,#,#,#,#,#,#,#,#,#,#,#,#,#,#,#,#,#,#,#,#,#,#,#,#,#,#,#,#,#,#,#,#,#,#,#,#,#,#,#,#,#,#,#,#,#,#,#,#,
#,#,#,#,#, , , ,#,#,#,#,#,#,#,#,#,#,#,#,#,#, , , ,#,#,#,#,#,#,#,#,#,#,#,#,#,#,#,#,#,#,#,#,#,#,#,#,#,
#,#,#,#, , , , , , , ,#,#,#,#,#,#,#, , , , , , , , , ,#,#,#,#,#,#,#,#,#,#,#,#, , , , , , , , ,#,#,#,
#,#,#, , , ,#,#,#, , , ,#,#,#,#,#, , , , ,#,#,#,#, , , ,#,#,#,#,#,#,#,#,#,#,#, , , , , , , , , ,#,#,
#,#,#, , ,#,#,#,#,#, , ,#,#,#,#, , , , ,#,#,#,#,#,#, , ,#,#,#,#,#,#,#,#,#,#,#,#,#,#, , , , , , ,#,#,
#,#, , ,#,#,#,#,#,#, , ,#,#,#, , , , , ,#,#,#,#,#,#, , , ,#,#,#,#,#,#,#,#,#,#,#,#,#,#,#, , , , ,#,#,
#,#, , ,#,#,#,#,#,#, , ,#,#,#, , , , , ,#,#,#,#,#,#,#, , ,#,#,#,#,#,#,#,#,#,#,#,#,#,#,#,#, , , ,#,#,
#,#, , , ,#,#,#,#,#, , ,#,#,#,#, , , , , ,#,#,#,#,#,#, , ,#,#,#,#,#,#,#,#,#,#,#,#,#,#,#,#, , ,#,#,#,
#,#, , , ,#,#,#,#,#, , ,#,#,#,#,#,#,#, , , ,#,#,#,#, , , ,#,#,#,#,#,#,#,#, ,#,#,#,#,#,#,#, , ,#,#,#,
#,#, , , ,#,#,#,#, , , ,#,#,#,#,#,#,#,#, , , ,#,#, , , , ,#,#,#,#,#,#,#, , , , ,#,#,#,#, , ,#,#,#,#,
#,#, , , , ,#,#, , , , ,#,#,#,#,#,#,#,#,#, , , , , , , , ,#,#,#,#,#,#,#,#, , , , , , , , , ,#,#,#,#,
#,#, , , , , , , , , , ,#,#,#,#,#,#,#,#,#, , , , , , , , ,#,#,#,#,#,#,#,#,#, , , , , , , , ,#,#,#,#,
#,#, , , , , , , , , , , ,#,#,#,#,#,#,#,#, , , , , , , , ,#,#,#,#,#,#,#,#,#, , , , , , , ,#,#,#,#,#,
#,#,#, , , , , ,#,#, , , ,#,#,#,#,#,#,#,#,#, , , , , , , ,#,#,#,#,#,#,#,#,#, , , , , , ,#,#,#,#,#,#,
#,#,#,#,#, , ,#,#,#,#, , ,#,#,#,#,#,#,#,#,#, , , , , , , ,#,#,#,#,#,#,#,#, , , , , , ,#,#,#,#,#,#,#,
#,#,#,#,#,#, ,#,#,#,#, ,#,#,#,#,#,#,#,#,#,#, , , , , , , , ,#,#,#,#,#,#, , , , , , , ,#,#,#,#,#,#,#,
#,#,#,#,#,#, , ,#,#, , ,#,#,#,#,#,#,#,#,#,#, , , ,#,#,#, , ,#,#,#,#,#,#, , , , , , , , ,#,#,#,#,#,#,
#,#,#,#,#,#, , , , , , ,#,#,#,#,#,#,#,#,#,#, , ,#,#,#,#,#, , ,#,#,#,#,#, , , , , , , , , ,#,#,#,#,#,
#,#,#,#,#, , , ,#,#, , , ,#,#,#,#,#,#,#,#,#,#,#,#,#,#,#,#,#, , ,#,#,#,#, , , , , , , , , , , ,#,#,#,
#,#,#,#,#, , ,#,#,#,#, , ,#,#,#,#,#,#,#,#,#,#,#,#,#,#,#,#,#,#, , , , , , , , , , , , , , , , ,#,#,#,
#,#,#,#,#, , ,#,#,#,#,#, , ,#,#,#,#,#,#,#,#,#,#,#,#,#,#,#,#,#,#, , , , , , , , , , , , , , , ,#,#,#,
#,#,#,#,#, , ,#,#,#,#,#,#, , ,#,#,#,#,#,#,#,#,#,#,#,#,#,#,#,#,#, , , , , , , , , , ,#,#, , , ,#,#,#,
#,#,#,#, , , ,#,#,#,#,#,#, , , ,#,#,#,#,#,#,#,#,#,#,#,#,#,#,#, , , , , , , , , , ,#,#,#,#, , ,#,#,#,
#,#,#,#, , , ,#,#,#,#,#, , , , ,#,#,#,#,#,#,#,#,#,#,#,#,#,#, , , , , , , , , ,#,#,#,#,#,#, , ,#,#,#,
#,#,#,#,#, , , ,#,#,#, , , , ,#,#,#,#,#,#,#,#,#,#,#,#,#,#, , ,#,#,#, , , , ,#,#,#,#,#,#,#, , , ,#,#,
#,#,#,#,#,#, , , , , , , , ,#,#,#,#,#,#,#,#,#,#,#, , , , , ,#,#,#,#,#,#, , ,#,#,#,#,#,#,#, , , ,#,#,
#,#,#,#,#,#, , , , , , ,#,#,#,#,#,#,#,#,#,#,#,#, , , , , , ,#,#,#,#,#,#,#, , ,#,#,#,#,#, , , ,#,#,#,
#,#,#,#,#, , , , , , ,#,#,#,#,#,#,#,#,#,#,#,#,#, , , , , , ,#,#,#,#,#,#,#, , , ,#,#,#, , , ,#,#,#,#,
#,#,#, , , , , , , , ,#,#,#,#,#,#,#,#, ,#,#,#,#, , , , , , ,#,#,#,#,#,#,#, , , , , , , , ,#,#,#,#,#,
#,#, , , , , , , , , ,#,#,#,#,#,#,#, , , ,#,#, , , , , , , ,#,#,#,#,#,#,#,#, , , , , ,#,#,#,#,#,#,#,
#, , , ,#,#, , , , ,#,#,#,#,#,#,#,#, , , , , , , , , , , , ,#,#,#,#,#,#,#,#,#,#,#,#,#,#,#,#,#,#,#,#,
#, , ,#,#,#,#, , , ,#,#,#,#,#,#,#,#,#, , , , , , , ,#,#,#,#,#,#,#,#,#,#,#,#,#,#,#,#,#,#,#,#,#,#,#,#,
#, , ,#,#,#,#,#, , , ,#,#,#,#,#,#,#,#,#, , , , , ,#,#,#,#,#,#,#,#,#,#,#,#,#,#,#,#,#,#,#,#,#,#,#,#,#,
#, , ,#,#,#,#,#, , , ,#,#,#,#,#,#,#,#,#, , , , ,#,#,#,#,#,#,#,#,#,#,#,#,#,#,#,#,#,#,#,#,#,#,#,#,#,#,
#, , ,#,#,#,#,#, , , ,#,#,#,#,#,#,#,#,#, , , ,#,#,#,#,#,#,#,#,#,#,#,#,#,#,#,#,#,#,#,#,#,#,#,#,#,#,#,
#, , ,#,#,#,#,#, , , , ,#,#,#,#,#,#,#,#, , , ,#,#,#,#,#,#,#,#,#,#,#,#,#,#,#,#,#,#,#,#,#,#,#,#,#,#,#,
#,#, , ,#,#,#,#, , , , , , , ,#,#,#,#, , , , , ,#,#,#,#,#,#,#,#,#,#,#,#,#,#,#,#,#,#,#,#,#,#,#,#,#,#,
#,#, , , ,#,#, , , , , , , , , , , , , , , , , ,#,#,#,#,#,#,#,#,#,#,#,#,#,#,#,#,#,#,#,#,#,#,#,#,#,#,
#,#,#, , , , , , , , , , , , , , , , , , , , , , , , , ,#,#,#,#,#,#, , ,#,#, , , ,#,#,#,#,#,#,#,#,#,
#,#,#,#, , , , , , , , ,#,#,#,#, , , , , , , , , , , , , , , , ,#,#, , , , , , , , ,#,#,#,#,#,#,#,#,
#,#,#,#,#, , , , , , ,#,#,#,#,#,#, , , , , ,#,#,#,#,#, , , , , ,#,#,#, , , ,#,#,#, , ,#,#,#,#,#,#,#,
#,#,#,#,#,#, , , , , ,#,#,#,#,#,#, , , , ,#,#,#,#,#,#,#,#,#,#, , ,#,#,#,#,#,#,#,#,#, , , ,#,#,#,#,#,
#,#,#,#,#,#,#, , , , ,#,#,#,#,#,#, , , , ,#,#,#,#,#,#,#,#,#,#, , ,#,#,#,#,#,#,#,#,#,#, , , ,#,#,#,#,
#,#,#,#,#,#,#, , , , ,#,#,#,#,#,#, , , , ,#,#,#,#,#,#,#,#,#,#,#, , ,#,#,#,#,#,#,#,#,#, , , ,#,#,#,#,
#,#,#,#,#,#,#, , , , ,#,#,#,#,#, , , , ,#,#,#,#,#,#,#,#,#,#,#,#, , , ,#,#,#,#,#,#,#, , , ,#,#,#,#,#,
#,#,#,#,#,#, , , , , , ,#,#,#, , , ,#,#,#,#,#,#,#,#,#,#,#,#,#,#,#, , , ,#,#,#,#, , , , , ,#,#,#,#,#,
#,#,#,#,#,#, , , , , , , , , , , ,#,#,#,#,#,#,#,#,#,#,#,#,#,#,#,#,#, , , ,#,#, , , , , ,#,#,#,#,#,#,
#,#,#,#,#,#,#, , , , , , , , , ,#,#,#,#,#,#,#,#,#,#,#,#,#,#,#,#,#,#,#, , , , , , , , ,#,#,#,#,#,#,#,
#,#,#,#,#,#,#,#,#,#,#,#,#,#,#,#,#,#,#,#,#,#,#,#,#,#,#,#,#,#,#,#,#,#,#,#,#,#, , ,#,#,#,#,#,#,#,#,#,#,
#,#,#,#,#,#,#,#,#,#,#,#,#,#,#,#,#,#,#,#,#,#,#,#,#,#,#,#,#,#,#,#,#,#,#,#,#,#,#,#,#,#,#,#,#,#,#,#,#,#,
