#,#,#,#,#,#,#,#,#,#,#,#,#,#,#,#,#,#,#,#,#,#,#,#,#,#,#,#,#,#,#,#,#,#,#,#,#,#,#,#,#,#,#,#,#,#,#,#,#,#,
#,#, , , ,#,#,#,#,#,#,#,#,#,#,#,#,#,#,#,#,#,#,#,#,#,#, , , ,#,#,#,#,#,#,#,#,#,#,#,#,#,#,#,#,#,#,#,#,
#, , , , , , ,#,#,#,#,#, , , , , , , , , ,#,#, , , , , , , , , , ,#,#,#,#,#,#,#,#,#,#,#,#,#,#,#,#,#,
#, , , , , , , ,#,#,#, , , , , , , , , , , , , , , , ,#,#,#, , , , ,#,#,#,#,#,#,#,#,#,#,#,#,#,#,#,#,
#, , , ,#,#, , , , , , , , ,#,#, , , , , , , , , , ,#,#,#,#,#, , , ,#,#,#,#,#,#,#,#,#,#,#,#,#,#,#,#,
#, , ,#,#,#,#, , , , , ,#,#,#,#,#,#,#,#,#,#,#,#,#,#,#,#,#,#,#, , , ,#,#,#,#,#,#,#,#,#,#,#,#,#,#,#,#,
#, , ,#,#,#,#,#, , , ,#,#,#,#,#,#,#,#,#,#,#,#,#,#,#,#,#,#,#,#, , ,#,#,#,#,#,#,#,#,#,#,#,#,#,#,#,#,#,
#, , ,#,#,#,#,#,#,#,#,#,#,#,#,#,#,#,#, , , , , ,#,#,#,#,#,#,#, , ,#,#,#,#,#,#,#,#,#,#,#,#,#,#,#,#,#,
#, , , ,#,#,#,#,#,#,#,#,#,#,#,#,#,#, , , , , , , , ,#,#,#,#, , ,#,#,#,#,#,#,#,#,#,#, , ,#,#,#,#,#,#,
#,#, , , , , , , , , , ,#,#,#,#, , , , ,#,#,#, , , , ,#,#, , , ,#,#,#,#,#,#, , , , , , , , ,#,#,#,#,
#,#,#, , , , , , , , , , ,#,#, , , ,#,#,#,#,#,#,#, , , , , , , ,#,#,#,#,#, , , , , , , , , , ,#,#,#,
#,#,#,#,#,#,#,#,#,#,#, , , , , , ,#,#,#,#,#,#,#,#,#, , , , , , ,#,#,#,#,#, , , ,#,#,#,#, , , , ,#,#,
#,#,#,#,#,#,#,#,#,#,#,#, , , , , ,#,#,#,#,#,#,#,#,#, , , , , ,#,#,#,#,#,#, , ,#,#,#,#,#,#, , , , ,#,
#,#,#,#,#,#,#,#,#,#,#,#, , , , ,#,#,#,#,#,#,#,#,#,#, , , , , ,#,#,#,#,#, , ,#,#,#,#,#,#,#,#, , , ,#,
#,#,#,#,#,#,#,#,#,#,#,#,#, , ,#,#,#,#,#,#,#,#,#,#,#, , , , , ,#,#,#,#, , , ,#,#,#,#,#,#,#,#, , ,#,#,
#,#,#,#, , ,#,#,#,#,#,#,#,#,#,#,#,#,#,#,#,#,#,#,#,#, , , , , , ,#,#, , , , , ,#,#,#,#,#,#,#, , ,#,#,
#,#,#, , , , , ,#,#,#,#,#,#,#,#,#,#,#,#,#,#,#,#,#, , , ,#,#, , , , , , , , , , , ,#,#,#,#, , ,#,#,#,
#,#,#, , , , , , ,#,#,#,#,#,#,#,#,#,#,#,#,#,#,#,#, , ,#,#,#,#, , , , , , , , , , , , , , , ,#,#,#,#,
#,#, , ,#,#,#, , ,#,#,#,#,#,#, , , ,#,#,#,#,#,#, , ,#,#,#,#,#,#, , , , , , ,#,#,#,#, , , ,#,#,#,#,#,
#, , ,#,#,#,#,#, , ,#,#,#,#, , , , , ,#,#,#,#,#, , ,#,#,#,#,#,#, , , , ,#,#,#,#,#,#,#,#,#,#,#,#,#,#,
#, , ,#,#,#,#,#, , , ,#,#, , , , , , , ,#,#,#, , ,#,#,#,#,#,#,#, , ,#,#,#,#,#,#,#,#,#,#,#,#,#,#,#,#,
#, , ,#,#,#,#,#, , , , , , , , , , , , , , , , , ,#,#,#,#,#,#, , ,#,#,#,#,#,#,#,#,#,#,#,#,#,#,#,#,#,
#,#, , ,#,#,#, , , , , , , , ,#,#, , , , , , , , ,#,#,#,#,#,#, , ,#,#,#,#,#,#,#,#,#,#,#,#,#,#,#,#,#,
#,#, , , , , , , , , , , , ,#,#,#,#,#, , , , , , ,#,#,#,#,#,#,#,#,#,#,#,#,#,#,#,#,#,#,#,#,#,#,#,#,#,
#,#,#, , , , , , , , , , ,#,#,#,#,#,#,#, , , , , ,#,#,#,#,#,#,#,#,#,#,#,#,#,#,#,#,#,#,#,#,#,#,#,#,#,
#,#,#,#, , , ,#,#,#, , , ,#,#,#,#,#,#,#, , , , ,#,#,#,#,#,#,#,#,#,#,#,#,#,#,#,#,#,#,#,#,#,#,#,#,#,#,
#,#,#,#,#,#,#,#,#,#,#, , , ,#,#,#,#,#, , , , ,#,#,#,#,#,#,#,#,#,#,#,#,#,#,#,#,#,#,#,#,#,#,#,#,#,#,#,
#,#,#,#,#,#,#,#,#,#,#, , , , ,#,#,#,#, , , ,#,#,#,#,#,#,#,#,#,#,#,#,#,#,#,#,#,#,#,#,#,#,#,#,#,#,#,#,
#,#,#,#,#,#,#,#,#,#,#,#, , , , ,#,#, , , ,#,#,#,#,#,#,#,#,#,#,#,#,#,#,#,#,#,#,#,#,#,#,#,#,#,#,#,#,#,
#,#,#,#,#,#,#,#,#,#,#,#,#, , , , , , , , ,#,#,#,#,#,#,#,#,#,#,#,#,#,#,#,#,#,#,#,#,#,#,#,#,#,#,#,#,#,
#,#,#,#,#,#,#,#,#,#,#,#,#,#, , , , , , , ,#,#,#,#,#,#,#,#,#,#,#,#,#,#,#,#,#,#,#,#,#,#,#,#,#,#,#,#,#,
#,#,#,#,#,#,#,#,#,#,#,#,#,#,#, , , , , , , ,#,#,#,#,#,#,#,#,#,#,#,#,#, , ,#,#,#,#,#,#,#,#,#,#,#,#,#,
#,#,#,#,#,#,#,#,#,#,#,#,#,#,#,#, , , , , , , ,#,#,#,#,#,#,#,#,#,#,#, , , , ,#,#,#,#,#,#,#,#,#,#,#,#,
#,#,#,#,#,#,#,#,#,#,#,#,#,#,#,#,#, , , ,#, , , ,#,#,#,#,#,#,#,#,#,#,#, , , , , ,#,#,#,#, , ,#,#,#,#,
#,#,#,#, , , ,#,#,#,#,#,#,#,#,#,#, , ,#,#,#, , ,#,#,#,#,#,#,#,#,#,#,#, , , , , , , , , , , , ,#,#,#,
#,#,#, , , , , , , , ,#,#,#,#,#,#, , , , , , , ,#,#,#,#,#,#,#,#,#,#, , , , , , , , , , , , , ,#,#,#,
#,#, , , , , , , , , , ,#,#,#,#,#, , , , , , , , ,#,#,#,#,#,#, , , , , , , ,#,#,#,#, , , , ,#,#,#,#,
#,#, , ,#,#,#,#, , , , ,#,#,#,#, , , , , , , , , , , , , , , , , , , , , ,#,#,#,#,#,#, , ,#,#,#,#,#,
#, , ,#,#,#,#,#,#, , , , ,#,#, , , ,#,#,#, , , , , , , , , , , , , , , ,#,#,#,#,#,#,#, , ,#,#,#,#,#,
#, , ,#,#,#,#,#,#,#, , , , , , , ,#,#,#,#,#,#, , , , , , , , , , , , , ,#,#,#,#,#,#,#, , ,#,#,#,#,#,
#, , ,#,#,#,#,#,#,#,#, , , , , ,#,#,#,#,#,#,#,#, , , , , , , , , , , , ,#,#,#,#,#,#, , , ,#,#,#,#,#,
#, , ,#,#,#,#,#,#,#,#,#,#,#,#,#,#,#,#,#,#,#,#,#, , , , , , , , , , , ,#,#,#,#,#,#, , , ,#,#,#,#,#,#,
#, , , ,#,#,#,#,#,#,#,#,#,#,#,#,#,#,#,#,#,#,#,#, , , , , , , , ,#,#,#,#,#,#,#,#,#, , , ,#,#,#,#,#,#,
#, , , , , , ,#,#,#,#,#,#,#,#,#,#,#,#,#,#,#,#, , , , , , , ,#,#,#,#,#,#,#,#,#,#,#, , ,#,#,#,#,#,#,#,
#, , , , , , ,#,#,#,#,#,#,#,#,#,#,#,#,#,#, , , , , , , , ,#,#,#,#,#,#,#,#,#,#,#,#,#,#,#,#,#,#,#,#,#,
#,#, , ,#,#,#,#,#,#,#,#,#,#,#,#,#,#,#, , , , , , ,#,#,#,#,#,#,#,#,#,#,#,#,#,#,#,#,#,#,#,#,#,#,#,#,#,
#,#,#,#,#,#,#,#,#,#,#,#,#,#,#,#,#,#,#, , , , , ,#,#,#,#,#,#,#,#,#,#,#,#,#,#,#,#,#,#,#,#,#,#,#,#,#,#,
#,#,#,#,#,#,#,#,#,#,#,#,#,#,#,#,#,#,#,#,#,#,#,#,#,#,#,#,#,#,#,#,#,#,#,#,#,#,#,#,#,#,#,#,#,#,#,#,#,#,
#,#,#,#,#,#,#,#,#,#,#,#,#,#,#,#,#,#,#,#,#,#,#,#,#,#,#,#,#,#,#,#,#,#,#,#,#,#,#,#,#,#,#,#,#,#,#,#,#,#,
#,#,#,#,#,#,#,#,#,#,#,#,#,#,#,#,#,#,#,#,#,#,#,#,#,#,#,#,#,#,#,#,#,#,#,#,#,#,#,#,#,#,#,#,#,#,#,#,#,#,
