#,#,#,#,#,#,#,#,#,#,#,#,#,#,#,#,#,#,#,#,#,#,#,#,#,#,#,#,#,#,#,#,#,#,#,#,#,#,#,#,#,#,#,#,#,#,#,#,#,#,
#,#, , , , , ,#,#,#,#,#,#,#,#,#,#,#,#, , , , , , , , ,#,#,#,#,#,#,#,#,#,#,#,#,#,#,#,#,#,#,#,#,#,#,#,
#, , , , , , , ,#,#,#,#,#,#,#,#,#,#, , , , , , , , , ,#,#,#,#,#,#,#,#,#,#,#,#,#,#,#,#,#,#,#,#,#,#,#,
#, , , ,#,#,#, , , ,#,#,#,#,#,#,#,#, , , ,#,#,#,#, , ,#,#,#,#,#,#,#,#,#,#,#,#,#,#,#,#,#,#,#,#,#,#,#,
#, , ,#,#,#,#,#, , , ,#,#,#,#,#,#,#, , ,#,#,#,#,#,#,#,#,#,#,#,#,#,#,#,#,#,#,#,#,#,#,#,#,#,#,#,#,#,#,
#, , ,#,#,#,#,#,#, , , , ,#,#,#,#, , , ,#,#,#,#,#,#,#,#,#,#,#,#,#,#,#, , , , ,#,#, , ,#,#,#,#,#,#,#,
#, , , ,#,#,#,#,#,#, , , , , , , , , , , ,#,#,#,#,#,#,#,#,#,#,#,#,#, , , , , , , , , , ,#,#,#,#,#,#,
#, , , , ,#,#,#,#,#,#, , , , , , , , , , , ,#,#,#,#,#,#,#,#,#,#,#,#, , , , , , , , , , , ,#,#,#,#,#,
#,#, , , ,#,#,#,#,#,#,#,#,#,#,#, , , , , , , , , , ,#,#,#,#,#,#,#,#,#, , , , ,#,#,#,#, , , ,#,#,#,#,
#,#,#, , ,#,#,#,#,#,#,#,#,#,#,#,#, , , , , , , , , , ,#,#,#,#,#,#,#,#,#, , ,#,#,#,#,#,#, , , ,#,#,#,
#,#,#,#,#,#,#,#,#,#,#,#,#,#,#,#,#, , , ,#,#, , , , , ,#,#,#,#,#,#,#,#,#, , ,#,#,#,#,#,#,#, , ,#,#,#,
#,#,#,#,#,#,#,#,#,#,#,#,#,#,#,#,#, , ,#,#,#,#, , , , , ,#,#,#,#,#,#,#, , , ,#,#,#,#,#,#,#, , ,#,#,#,
#,#,#,#,#,#,#,#,#,#,#,#,#,#,#,#, , , ,#,#,#,#, , , , , ,#,#,#,#, , , , , , , ,#,#,#,#,#, , ,#,#,#,#,
#,#,#,#,#,#,#,#,#, , ,#,#,#,#, , , ,#,#,#,#,#, , , , , , ,#,#, , , , , , , , , , , , , , , ,#,#,#,#,
#,#,#,#,#,#,#,#, , , , ,#,#, , , ,#,#,#,#,#,#, , , ,#,#, , , , , , , , , , , , , , , , , , ,#,#,#,#,
#,#,#,#,#,#,#,#, , , , , , , , ,#,#,#,#,#,#,#, , ,#,#,#,#, , , , , , , , , ,#,#,#,#,#, , ,#,#,#,#,#,
#,#,#,#,#,#,#, , , , , , , , , ,#,#,#,#,#,#, , ,#,#,#,#,#,#, , , , , , , ,#,#,#,#,#,#,#,#,#,#,#,#,#,
#,#,#, , , , , , , , , , , , ,#,#,#, , , , , , ,#,#,#,#,#,#, , , , , , ,#,#,#,#,#,#,#,#,#,#,#,#,#,#,
#,#, , , , , , , , , , , , ,#,#,#, , , , , , , ,#,#,#,#,#, , , , , , , ,#,#,#,#,#,#,#,#,#,#,#,#,#,#,
#, , , ,#,#, , , , , , , ,#,#,#, , , , , , , , , ,#,#,#, , , , , , , ,#,#,#,#,#,#,#,#,#,#,#,#,#,#,#,
#, , ,#,#,#,#, , , , , , , ,#, , , , , , , , , , , , , , , , , , , ,#,#,#,#,#,#,#,#,#,#,#,#,#,#,#,#,
#, , ,#,#,#,#, , , , , , , , , , , , ,#,#,#, , , , , , ,#,#,#,#,#,#,#,#,#,#,#,#,#,#,#,#,#,#,#,#,#,#,
#, , ,#,#,#,#, , , , , , , , , , , ,#,#,#,#,#,#,#,#,#,#,#,#,#,#,#,#,#,#,#,#,#,#,#,#,#,#,#,#,#,#,#,#,
#, , ,#,#,#,#, , , , , , , , , , , ,#,#,#,#,#,#,#,#,#,#,#,#,#,#,#,#,#,#,#,#,#,#,#,#,#,#,#,#,#,#,#,#,
#, , , ,#,#, , , , , , , , ,#,#, , , ,#,#,#,#,#,#,#,#,#,#,#,#,#,#,#,#,#,#,#,#,#,#,#,#,#,#,#,#,#,#,#,
#,#, , , , , , , , , , ,#,#,#,#,#, , , ,#,#,#,#,#,#,#,#,#,#,#,#,#,#,#,#,#,#,#,#,#,#,#,#,#,#,#,#,#,#,
#,#,#, , , , , , , , ,#,#,#,#,#,#,#, , , ,#,#,#,#,#,#,#,#,#,#,#,#,#,#,#,#,#,#,#,#,#,#,#,#,#,#,#,#,#,
#,#,#,#,#,#,#, , , , ,#,#,#,#,#,#,#,#, , , ,#,#,#,#,#,#,#,#,#,#,#,#,#,#,#,#,#,#,#,#,#,#,#,#,#,#,#,#,
#,#,#,#,#,#,#,#, , , , ,#,#,#,#,#,#,#,#, , , ,#,#,#,#,#,#,#,#,#,#,#,#,#,#,#,#,#,#,#,#,#,#,#,#,#,#,#,
#,#,#,#,#,#,#,#,#, , , , ,#,#,#,#,#,#,#, , , ,#,#,#,#,#,#,#,#,#,#,#,#,#,#,#,#,#,#,#,#,#,#,#,#,#,#,#,
#,#,#,#,#,#,#,#,#,#, , , , ,#,#,#,#,#, , , , ,#,#,#,#,#,#,#,#,#,#,#,#,#,#,#,#,#,#, , ,#,#,#,#,#,#,#,
#,#,#,#,#,#,#,#,#,#,#, , , , , , , , , , , , ,#,#,#,#,#,#,#,#,#,#,#,#,#,#,#,#,#, , , , , ,#,#,#,#,#,
#,#,#,#,#,#,#,#,#,#,#, , , , , , , , , , , , , ,#,#,#,#,#,#,#,#,#,#,#,#,#,#,#, , , , , , , ,#,#,#,#,
#,#,#,#,#,#,#,#,#,#,#, , , , , , , , , , , , , , ,#,#, , ,#,#,#,#,#,#,#,#,#, , , ,#,#,#, , ,#,#,#,#,
#,#,#,#,#,#,#,#,#,#, , , , , , ,#,#, , , , , , , , , , , , ,#,#,#,#,#,#, , , , ,#,#,#,#,#, ,#,#,#,#,
#,#,#,#,#,#,#,#,#, , , , , , ,#,#,#,#, , , , , , , , , , , , ,#,#,#, , , , , ,#,#,#,#,#,#, , ,#,#,#,
#,#,#,#,#,#,#,#, , , , , , , ,#,#,#,#, , , , , , , ,#,#,#, , , , , , , , , , ,#,#,#,#,#,#, , ,#,#,#,
#,#,#,#,#, , , , , , , , , ,#,#,#,#,#,#, , , , , ,#,#,#,#,#, , , , , , , , , , ,#,#,#,#, , ,#,#,#,#,
#,#,#,#, , , , ,#,#,#,#,#,#,#,#,#,#,#,#,#, , , , ,#,#,#,#,#,#, , , , , , , , , , , , , , , ,#,#,#,#,
#,#,#, , , , ,#,#,#,#,#,#,#,#,#,#,#,#,#,#,#, , , ,#,#,#,#,#,#, , , , , , , , , , , , , , ,#,#,#,#,#,
#,#, , , , ,#,#,#,#,#,#,#,#,#,#,#,#,#,#,#,#, , , , ,#,#,#,#, , , ,#,#,#,#, , , , , , , ,#,#,#,#,#,#,
#,#, , , ,#,#,#,#,#,#, , ,#,#,#,#,#,#,#,#,#,#, , , , , , , , , ,#,#,#,#,#,#, , ,#,#,#,#,#,#,#,#,#,#,
#,#, , , ,#,#,#,#,#, , , , ,#,#,#,#,#,#,#,#,#, , , , , , , , , ,#,#,#,#,#,#,#,#,#,#,#,#,#,#,#,#,#,#,
#,#,#, , , ,#,#,#, , , , , , ,#,#,#,#,#,#,#,#,#, , ,#,#,#,#, , , ,#,#,#,#,#,#,#,#,#,#,#,#,#,#,#,#,#,
#,#,#,#,#, , , , , , , , , , ,#,#,#,#,#,#,#,#,#,#,#,#,#,#,#,#, , , , ,#,#,#,#,#,#,#,#,#,#,#,#,#,#,#,
#,#,#,#,#,#, , , , , , , , ,#,#,#,#,#,#,#,#,#,#,#,#,#,#,#,#,#, , , , , ,#,#,#,#,#,#,#,#,#,#,#,#,#,#,
#,#,#,#,#,#,#,#,#, , ,#,#,#,#,#,#,#,#,#,#,#,#,#,#,#,#,#,#,#,#,#, , , , ,#,#,#,#,#,#,#,#,#,#,#,#,#,#,
#,#,#,#,#,#,#,#,#,#,#,#,#,#,#,#,#,#,#,#,#,#,#,#,#,#,#,#,#,#,#,#,#, , ,#,#,#,#,#,#,#,#,#,#,#,#,#,#,#,
#,#,#,#,#,#,#,#,#,#,#,#,#,#,#,#,#,#,#,#,#,#,#,#,#,#,#,#,#,#,#,#,#,#,#,#,#,#,#,#,#,#,#,#,#,#,#,#,#,#,
#,#,#,#,#,#,#,#,#,#,#,#,#,#,#,#,#,#,#,#,#,#,#,#,#,#,#,#,#,#,#,#,#,#,#,#,#,#,#,#,#,#,#,#,#,#,#,#,#,#,
