#,#,#,#,#,#,#,#,#,#,#,#,#,#,#,#,#,#,#,#,#,#,#,#,#,#,#,#,#,#,#,#,#,#,#,#,#,#,#,#,#,#,#,#,#,#,#,#,#,#,
#,#,#,#,#,#,#,#,#,#,#,#,#,#,#,#,#,#,#,#,#,#,#,#,#,#,#,#,#,#,#,#,#,#,#,#,#,#,#,#,#,#,#,#,#,#,#,#,#,#,
#,#,#,#,#,#,#,#,#,#,#,#,#,#, , , , , ,#,#,#,#,#,#,#,#,#,#,#,#,#,#,#,#,#,#,#,#,#,#,#,#,#,#,#,#,#,#,#,
#,#,#,#,#,#,#,#,#,#,#,#,#, , , , , , , ,#,#,#,#,#,#,#,#,#,#,#,#,#,#,#,#,#, , , , , , , ,#,#,#,#,#,#,
#,#,#, , , , , ,#,#,#,#, , ,#,#,#,#, , , ,#,#,#,#,#,#,#,#,#,#,#,#,#,#,#, , , , , , , , , ,#,#,#,#,#,
#,#, , , , , , , , , , , ,#,#,#,#,#,#, , , ,#,#,#,#,#,#,#,#, , ,#,#,#, , , ,#,#,#,#,#, , ,#,#,#,#,#,
#, , , ,#,#,#, , , , , ,#,#,#,#,#,#,#,#, , ,#,#,#,#,#,#,#, , , , , , , , ,#,#,#,#,#,#,#, ,#,#,#,#,#,
#, , ,#,#,#,#,#, , , , ,#,#,#,#,#,#,#,#, , , ,#,#, , , , , , , , , , , ,#,#,#,#,#,#,#,#, , ,#,#,#,#,
#, , ,#,#,#,#,#, , , , , ,#,#,#, , ,#, , , , , , , , , , , , , , , , , ,#,#,#,#,#,#,#,#, , ,#,#,#,#,
#, , ,#,#,#,#,#, , , , , , , , , , , , , , , , , , ,#,#,#,#,#, , , , , , ,#,#,#,#,#,#, , , ,#,#,#,#,
#, , ,#,#,#,#, , , , , , , , , , , , , , , , , , ,#,#,#,#,#,#,#, , , , , , , , , , , , , , ,#,#,#,#,
#,#, , ,#,#, , , , , ,#,#,#,#,#,#,#,#, , , , , ,#,#,#,#,#,#,#,#, , , , , , , , , , , , , , ,#,#,#,#,
#,#,#, , , , , , , ,#,#,#,#,#,#,#,#,#,#,#, , , ,#,#,#,#,#,#,#, , , , , , , , , , , , , , ,#,#,#,#,#,
#,#,#, , , , , , , ,#,#,#,#, , , ,#,#,#,#,#, , , ,#,#,#,#,#, , , , ,#,#,#, , , , , , ,#,#,#,#,#,#,#,
#,#,#, , , , , , , , ,#,#, , , , , ,#,#,#,#,#, , , ,#,#, , , , , ,#,#,#,#,#, , , , ,#,#,#,#,#,#,#,#,
#,#,#,#, , , , , , , , , , , , , , ,#,#,#,#,#,#, , , , , , , , ,#,#,#,#,#,#, , , , ,#,#,#,#,#,#,#,#,
#,#,#,#,#, , , , , , , , , , , , ,#,#,#,#,#,#,#,#, , , , , , ,#,#,#,#,#,#,#,#, , , , ,#,#,#,#,#,#,#,
#,#,#,#,#,#, , , , , , , , , ,#,#,#,#,#,#,#,#,#,#,#,#,#,#,#,#,#,#,#,#,#,#,#,#, , , , , ,#,#,#,#,#,#,
#,#,#,#,#,#, , , , , , , , ,#,#,#,#,#,#,#,#,#,#,#,#,#,#,#,#,#,#,#,#,#,#,#,#,#,#, , , , ,#,#,#,#,#,#,
#,#,#,#,#,#, , , , , , , , ,#,#,#,#,#,#,#,#,#,#,#,#,#,#,#,#,#,#,#,#,#,#,#,#,#,#, , , , ,#,#,#,#,#,#,
#,#,#,#,#,#, , ,#,#,#,#, , , ,#,#,#,#,#,#,#,#,#,#,#,#,#,#,#,#,#,#,#,#,#,#,#,#,#, , , , , ,#,#,#,#,#,
#,#,#,#,#, , ,#,#,#,#,#,#, , ,#,#,#,#,#,#,#,#,#,#,#,#,#,#,#,#,#,#,#,#,#,#,#,#, , , , , , ,#,#,#,#,#,
#,#,#,#,#, , ,#,#,#,#,#,#, , , ,#,#,#,#,#,#,#,#,#,#,#,#,#,#,#,#,#,#,#,#,#,#, , , , , , ,#,#,#,#,#,#,
#,#,#,#,#, , , ,#,#,#,#,#,#, , , ,#,#,#,#,#,#,#,#,#,#,#,#,#,#,#,#,#,#,#,#,#, , ,#,#,#,#,#,#,#,#,#,#,
#,#,#,#,#,#, , ,#,#,#,#,#,#, , , , ,#,#,#,#,#,#,#,#,#,#,#,#,#,#,#,#,#,#,#, , ,#,#,#,#,#,#,#,#,#,#,#,
#,#,#,#,#,#,#, , ,#,#,#,#, , , , , , , ,#,#,#,#,#,#,#,#,#,#,#,#,#,#,#,#,#, , ,#,#,#,#,#,#,#,#,#,#,#,
#,#,#,#,#,#,#, , , , , , , , , , , , , , , , , , , , , ,#,#,#,#,#,#,#,#, , , ,#,#,#,#,#,#,#,#,#,#,#,
#,#,#,#,#,#, , , , , , , , , , , , , , , , , , , , , , , ,#,#,#,#,#,#,#, , , ,#,#,#,#,#,#,#,#,#,#,#,
#,#,#,#,#, , , , , , , , , , , , , , ,#,#,#,#,#,#,#,#, , , ,#,#,#,#,#, , , , ,#,#,#,#,#,#,#,#,#,#,#,
#,#,#,#, , , , , , , , , , , , , , , ,#,#,#,#,#,#,#,#,#, , , ,#,#,#,#, , , , , ,#,#,#,#,#,#,#,#,#,#,
#,#,#, , , , , , , , , , ,#,#, , , , , ,#,#,#,#,#,#,#,#, , , ,#,#,#,#, , , , , , , ,#,#,#,#,#,#,#,#,
#,#,#, , , ,#,#,#,#, , ,#,#,#,#, , , , , ,#,#,#,#,#,#,#,#, , ,#,#,#,#,#, , , , , , , ,#,#,#,#,#,#,#,
#,#,#, , ,#,#,#,#,#,#, ,#,#,#,#,#,#, , , , , ,#,#,#,#,#,#, , ,#,#,#,#,#, , , , , , , ,#,#,#,#,#,#,#,
#,#, , , ,#,#,#,#,#,#, , ,#,#,#,#,#,#, , , , , , ,#,#,#, , , ,#,#,#,#, , , , , , , ,#,#,#,#,#,#,#,#,
#,#, , ,#,#,#,#,#,#,#, , ,#,#,#,#,#,#,#, , , , , , , , , , , , ,#,#, , , , ,#,#, , ,#,#,#,#,#,#,#,#,
#,#, , ,#,#,#,#,#,#,#, , ,#,#,#,#,#,#,#, , , , , , , , , , , , , , , , , , , , , , , ,#,#,#,#,#,#,#,
#,#, , , ,#,#,#,#,#,#, , ,#,#,#,#,#,#,#,#, , , , , , , , , , , , , , , , , , , , , , ,#,#,#,#,#,#,#,
#,#, , , , ,#,#,#,#,#, , ,#,#,#,#,#,#,#,#,#,#,#,#,#,#, , , , , , , , , , , , , , , ,#,#,#,#,#,#,#,#,
#,#, , , , , ,#,#,#, , , ,#,#,#,#,#,#,#,#,#,#,#,#,#,#,#,#,#, , , , , ,#,#,#, , , , ,#,#,#,#,#,#,#,#,
#,#, , , , , , ,#,#, , , , ,#,#,#,#,#,#,#,#,#,#,#,#,#,#,#,#,#, , , ,#,#,#,#,#, , , ,#,#,#,#,#,#,#,#,
#,#, , , , , , ,#,#, , , , , ,#,#,#,#,#,#,#,#,#,#,#,#,#,#,#,#, , , ,#,#,#,#,#,#, , ,#,#,#,#,#,#,#,#,
#,#, , , , , ,#,#,#, , , , , , ,#,#,#,#,#,#,#,#,#,#,#,#,#,#,#, , , ,#,#,#,#,#,#, , ,#,#,#,#,#,#,#,#,
#,#, , , , , , ,#, , , , , , , , , ,#,#,#,#,#,#,#,#,#,#,#,#,#, , , , ,#,#,#,#,#, , ,#,#,#,#,#,#,#,#,
#,#,#, , , , , , , , ,#,#,#, , , , , ,#,#,#,#,#,#,#,#,#,#,#,#, , , , ,#,#,#,#, , , ,#,#,#,#,#,#,#,#,
#,#,#,#,#, , , , , ,#,#,#,#,#, , , , ,#,#,#,#,#,#,#,#,#,#,#,#,#, , , , ,#,#, , , , ,#,#,#,#,#,#,#,#,
#,#,#,#,#,#,#, , , ,#,#,#,#,#, , , , ,#,#,#,#,#,#,#,#,#,#,#,#,#,#,#, , , , , , , ,#,#,#,#,#,#,#,#,#,
#,#,#,#,#,#,#,#, , , ,#,#,#, , , , , ,#,#,#,#,#,#,#,#,#,#,#,#,#,#,#,#,#, , , ,#,#,#,#,#,#,#,#,#,#,#,
#,#,#,#,#,#,#,#,#, , , , , , , , , ,#,#,#,#,#,#,#,#,#,#,#,#,#,#,#,#,#,#,#,#,#,#,#,#,#,#,#,#,#,#,#,#,
#,#,#,#,#,#,#,#,#,#, , , , , ,#,#,#,#,#,#,#,#,#,#,#,#,#,#,#,#,#,#,#,#,#,#,#,#,#,#,#,#,#,#,#,#,#,#,#,
#,#,#,#,#,#,#,#,#,#,#,#,#,#,#,#,#,#,#,#,#,#,#,#,#,#,#,#,#,#,#,#,#,#,#,#,#,#,#,#,#,#,#,#,#,#,#,#,#,#,
