#,#,#,#,#,#,#,#,#,#,#,#,#,#,#,#,#,#,#,#,#,#,#,#,#,#,#,#,#,#,#,#,#,#,#,#,#,#,#,#,#,#,#,#,#,#,#,#,#,#,
#,#,#,#,#,#,#,#, , , ,#,#,#,#,#,#,#,#,#,#,#,#,#,#,#,#,#,#,#,#,#,#,#,#,#,#,#,#,#,#,#,#,#,#,#,#,#,#,#,
#,#,#,#,#,#,#, , , , , , ,#,#,#,#,#,#,#,#,#,#,#,#,#, , , , , ,#,#, , ,#,#,#,#,#, , , , , ,#,#,#,#,#,
#,#,#,#,#,#, , ,#,#,#, , , ,#,#,#,#,#,#,#,#,#,#, , , , , , , , , , , , ,#,#,#, , , , , , , , ,#,#,#,
#,#,#,#,#, , ,#,#,#,#,#, , , ,#,#,#,#,#,#,#,#, , , , ,#,#,#, , , , , , , , , , , , ,#,#, , , , ,#,#,
#,#,#,#, , , ,#,#,#,#,#,#, , ,#,#,#,#,#,#,#,#, , , ,#,#,#,#,#, , , , , , , , , , ,#,#,#,#, , , ,#,#,
#,#,#,#, , , ,#,#,#,#,#,#, , ,#,#,#,#,#,#,#,#, , , ,#,#,#,#,#, , , , , , , , , ,#,#,#,#,#, , , ,#,#,
#,#,#,#,#, , ,#,#,#,#,#, , ,#,#,#,#,#,#,#,#,#,#, , ,#,#,#,#,#, , , , , , , , ,#,#,#,#,#,#, , , ,#,#,
#,#,#,#,#, , ,#,#,#,#,#, , ,#,#,#,#,#,#,#,#,#,#,#, , ,#,#,#, , , , , , , , , ,#,#,#,#,#,#, , , ,#,#,
#,#,#,#,#, , ,#,#,#,#, , ,#,#,#,#,#,#,#,#,#,#,#,#, , ,#,#, , , , , , , , , , ,#,#,#,#,#, , , , ,#,#,
#,#,#,#,#,#, , ,#,#, , , ,#,#,#,#,#,#,#,#,#,#,#,#, , ,#,#, , , , ,#,#,#, , , ,#,#,#,#, , , , , ,#,#,
#,#,#,#,#,#,#, , , , , ,#,#,#,#,#,#,#,#,#,#,#,#,#, , ,#,#, , , ,#,#,#,#,#, , , ,#,#, , , , , ,#,#,#,
#,#,#,#,#,#,#, , , , ,#,#,#,#,#,#,#,#,#,#,#,#,#, , ,#,#, , , ,#,#,#,#,#,#,#, , , , , , , , ,#,#,#,#,
#,#,#,#,#,#,#, , , ,#,#,#,#,#,#,#,#,#,#,#,#,#, , ,#,#,#, , , ,#,#,#,#,#,#,#,#, , , , , , ,#,#,#,#,#,
#,#,#,#,#,#, , , , ,#,#,#,#,#,#,#,#,#, , , , , , ,#,#, , , , ,#,#,#,#,#,#,#,#,#, , , , , ,#,#,#,#,#,
#,#,#,#,#, , , , , ,#,#,#,#,#,#,#,#, , , , , , ,#,#, , , , , ,#,#,#,#,#,#,#,#,#, , , , , ,#,#,#,#,#,
#,#,#,#, , , , , , , ,#,#,#,#,#,#,#, , , , , ,#,#,#, , , , , ,#,#,#,#,#,#,#,#,#, , , , , ,#,#,#,#,#,
#,#,#,#, , ,#,#, , , , ,#,#,#,#,#,#, , , , ,#,#,#,#, , , , , ,#,#,#,#,#,#,#,#, , , , , , ,#,#,#,#,#,
#,#,#, , ,#,#,#,#, , , , ,#,#,#,#,#, , , ,#,#,#,#,#, , , , ,#,#,#,#,#,#,#,#,#, , , , , , , ,#,#,#,#,
#,#, , , ,#,#,#,#,#, , , ,#,#,#,#,#, , ,#,#,#,#,#,#,#, , , ,#,#,#,#,#,#,#,#, , ,#,#, , , , ,#,#,#,#,
#,#, , ,#,#,#,#,#,#, , , ,#,#,#,#,#, , ,#,#,#,#,#,#,#, , ,#,#,#,#,#,#,#,#, , ,#,#,#,#, , , ,#,#,#,#,
#,#, , ,#,#,#,#,#,#, , , ,#,#,#,#,#, , ,#,#,#,#,#,#, , ,#,#,#,#,#,#,#,#, , , ,#,#,#,#, , ,#,#,#,#,#,
#,#, , ,#,#,#,#,#,#, , , ,#,#,#,#,#,#, , ,#,#,#,#, , , ,#,#,#,#,#,#,#, , , ,#,#,#,#,#, , ,#,#,#,#,#,
#,#, , , ,#,#,#,#,#, , , ,#,#,#,#,#,#, , , ,#,#, , , ,#,#,#,#,#,#,#,#, , , ,#,#,#,#,#,#, ,#,#,#,#,#,
#,#,#, , , , , , ,#, , , , ,#,#,#,#,#, , , , , , , ,#,#,#,#,#,#,#,#,#, , , ,#,#,#,#,#,#, , ,#,#,#,#,
#,#,#, , , , , , , , , , , ,#,#,#,#,#, , , , , , ,#,#,#,#,#,#,#,#,#,#, , , ,#,#,#,#,#,#, , ,#,#,#,#,
#,#, , , , , , , , , , , , ,#,#,#,#, , , , , , ,#,#,#,#,#,#,#,#,#,#,#, , , , ,#,#,#,#, , ,#,#,#,#,#,
#,#, , , , , , , , , , , , , ,#,#, , , , , , ,#,#,#,#,#,#,#,#,#,#,#,#, , , , , ,#,#, , , ,#,#,#,#,#,
#,#, , , , , , , , , , , , , , , , , , , , , ,#,#,#,#,#,#,#,#,#,#,#,#, , , , , , , , , , , ,#,#,#,#,
#,#, , , , , , , , , , , , , , , ,#,#, , , ,#,#,#,#,#,#,#,#,#,#,#,#,#, , , , , , , , , , , ,#,#,#,#,
#, , , ,#,#,#, , , , , , , , ,#,#,#,#,#, , ,#,#,#,#,#,#,#,#,#,#,#,#,#,#, , , , , , , , , , ,#,#,#,#,
#, , , , ,#, , , , , , , , ,#,#,#,#,#,#, , , ,#,#,#,#,#,#,#,#,#,#,#,#,#, , , , , , , , , ,#,#,#,#,#,
#, , , , , , , , , , , , , ,#,#,#,#,#,#, , , ,#,#,#,#,#,#,#,#,#,#,#,#,#,#, , , , , , ,#,#,#,#,#,#,#,
#, , , , , , , , , , , , , ,#,#,#,#,#,#, , ,#,#,#,#,#,#,#,#,#,#,#,#,#,#,#, , , , , ,#,#,#,#,#,#,#,#,
#,#, , , , , , , , , , , , ,#,#,#,#,#,#, , ,#,#,#,#,#,#,#,#,#,#,#,#,#,#,#, , , , , ,#,#,#,#,#,#,#,#,
#,#, , , , , , , , , , , , , ,#,#,#,#,#, , ,#,#,#,#,#,#,#,#,#,#,#,#,#,#, , , , , , ,#,#,#,#,#,#,#,#,
#,#, , , , , , , , , , , , , , , ,#,#, , , ,#,#,#,#,#,#,#,#,#,#,#,#,#, , , ,#,#, , , ,#,#,#,#,#,#,#,
#,#, , , ,#,#,#, , , , , , , , , , , , , , , ,#,#,#,#,#,#,#,#,#,#,#, , , ,#,#,#,#, , ,#,#,#,#,#,#,#,
#,#, , ,#,#,#,#,#, , , , , , , , , , , , , , ,#,#,#,#,#,#,#,#,#,#,#, , , ,#,#,#,#,#, , ,#,#,#,#,#,#,
#, , ,#,#,#,#,#,#, , , ,#,#,#,#, , , , , , , , ,#,#,#,#,#,#,#,#,#,#, , , ,#,#,#,#,#, , ,#,#,#,#,#,#,
#, , ,#,#,#,#,#,#, , ,#,#,#,#,#,#, , , ,#,#, , , , , , ,#,#,#,#,#,#, , , ,#,#,#,#,#, , ,#,#,#,#,#,#,
#, , ,#,#,#,#,#, , , ,#,#,#,#,#,#, , ,#,#,#,#, , , , , , ,#,#,#,#,#, , , , ,#,#,#, , , ,#,#,#,#,#,#,
#, , , ,#,#,#, , , , ,#,#,#,#,#,#, , ,#,#,#,#,#, , , , , ,#,#,#,#,#, , , , , , , , , , ,#,#,#,#,#,#,
#,#, , , , , , , , ,#,#,#,#,#,#,#, , ,#,#,#,#,#,#, , , , ,#,#,#,#, , , , , , , , , , ,#,#,#,#,#,#,#,
#,#,#, , , , , , ,#,#,#,#,#,#,#,#, , ,#,#,#,#,#,#, , , ,#,#,#,#,#, , , ,#,#, , ,#,#,#,#,#,#,#,#,#,#,
#,#,#,#,#,#,#,#,#,#,#,#,#,#,#,#,#, , ,#,#,#,#,#,#, , , ,#,#,#,#,#,#, ,#,#,#,#,#,#,#,#,#,#,#,#,#,#,#,
#,#,#,#,#,#,#,#,#,#,#,#,#,#,#,#,#, , , ,#,#,#,#, , , ,#,#,#,#,#,#,#,#,#,#,#,#,#,#,#,#,#,#,#,#,#,#,#,
#,#,#,#,#,#,#,#,#,#,#,#,#,#,#,#,#,#, , , , , , , , ,#,#,#,#,#,#,#,#,#,#,#,#,#,#,#,#,#,#,#,#,#,#,#,#,
#,#,#,#,#,#,#,#,#,#,#,#,#,#,#,#,#,#,#,#, , , ,#,#,#,#,#,#,#,#,#,#,#,#,#,#,#,#,#,#,#,#,#,#,#,#,#,#,#,
#,#,#,#,#,#,#,#,#,#,#,#,#,#,#,#,#,#,#,#,#,#,#,#,#,#,#,#,#,#,#,#,#,#,#,#,#,#,#,#,#,#,#,#,#,#,#,#,#,#,
