#,#,#,#,#,#,#,#,#,#,#,#,#,#,#,#,#,#,#,#,#,#,#,#,#,#,#,#,#,#,#,#,#,#,#,#,#,#,#,#,#,#,#,#,#,#,#,#,#,#,
#,#,#,#,#,#,#,#,#,#,#,#,#,#,#,#,#,#,#,#,#,#,#,#,#,#,#,#,#,#,#,#,#,#,#, , , , , , , , ,#,#,#,#,#,#,#,
#,#,#,#,#,#,#,#,#,#,#,#,#,#,#,#,#,#,#,#,#,#,#,#,#,#,#,#,#,#,#, , , , , , , , , , , , , ,#,#,#,#,#,#,
#,#,#,#,#,#,#,#,#,#,#,#,#,#,#,#, ,#,#,#,#,#,#,#,#,#,#,#,#,#, , , , , , , , ,#,#,#, , , , ,#,#,#,#,#,
#,#,#,#,#,#, , , , , ,#,#,#,#, , , ,#,#,#,#,#,#, ,#,#,#,#,#, , , , , , , ,#,#,#,#,#, , , ,#,#,#,#,#,
#,#,#, , , , , , , , , ,#,#, , , ,#,#,#,#,#,#, , , ,#,#,#,#,#, , , , , , ,#,#,#,#,#, , , , ,#,#,#,#,
#,#, , , , , , , , , , , , , , ,#,#,#,#,#,#,#,#, , , ,#,#,#,#,#, , , , , , ,#,#,#, , , , , ,#,#,#,#,
#, , , , , , , , , , , , , , , ,#,#,#,#,#,#,#,#, , , ,#,#,#,#,#,#, , , , , , , , , , , , , ,#,#,#,#,
#, , , ,#,#,#,#,#, , , , , , , , ,#,#,#,#,#,#, , , , ,#,#,#,#,#,#,#, , ,#,#, , , ,#,#, , , ,#,#,#,#,
#, , ,#,#,#,#,#,#,#, , , , , , , , , , , , , , , , , ,#,#,#,#,#,#,#,#,#,#,#,#, , ,#,#,#, , ,#,#,#,#,
#, , ,#,#,#,#,#,#,#, , , , , , , , , , , , , , , , , ,#,#,#,#,#,#,#,#,#,#,#,#, , , ,#,#,#,#,#,#,#,#,
#, , , ,#,#,#,#,#, , , ,#,#,#,#,#,#,#,#,#, , , , , , , ,#,#,#,#,#,#,#,#,#,#,#, , , ,#,#,#,#,#,#,#,#,
#, , , , ,#,#,#, , , ,#,#,#,#,#,#,#,#,#,#,#, , , , , , , ,#,#,#,#,#,#,#,#,#,#, , ,#,#,#,#,#,#,#,#,#,
#,#, , , , , , , , ,#,#,#,#,#,#,#,#,#,#,#,#,#, , , , , , , , ,#,#,#,#,#,#,#, , , ,#,#,#,#,#,#,#,#,#,
#,#,#, , , , , , ,#,#,#,#,#,#,#,#,#,#,#,#,#,#,#, , , , , , , , ,#,#, , , , , , , ,#,#,#,#,#,#,#,#,#,
#,#,#,#,#,#,#,#,#,#,#,#,#,#,#,#,#,#,#,#,#,#,#,#, , , , ,#,#,#, , , , , , , , , , ,#,#,#,#,#,#,#,#,#,
#,#,#,#,#,#,#,#,#,#,#,#,#,#,#,#,#,#,#,#,#,#,#,#, , , ,#,#,#,#,#, , , , ,#,#,#, , ,#,#,#,#,#,#,#,#,#,
#,#,#,#,#,#,#,#,#,#,#,#,#,#,#,#,#,#,#,#,#,#,#, , , ,#,#,#,#,#,#,#, , ,#,#,#,#,#, , ,#,#,#,#, , ,#,#,
#,#,#,#,#,#,#,#,#,#,#,#,#,#,#,#,#,#,#,#,#,#, , , , ,#,#,#,#,#,#,#,#, ,#,#,#,#,#, , ,#,#,#, , , ,#,#,
#,#,#,#,#,#,#,#,#,#,#,#,#,#,#,#,#, , , , , , , , , , ,#,#,#,#,#,#,#, , ,#,#,#, , , , ,#, , , , ,#,#,
#,#,#,#,#,#,#,#,#,#,#,#,#,#,#, , , , , , , , , , , , , ,#,#,#,#,#, , , , , , , , , , , , , , , ,#,#,
#,#,#,#,#,#,#,#,#,#,#,#,#,#, , , , , , , , , , , , , , , ,#,#,#, , , , , , , , , , , , , , , ,#,#,#,
#,#,#,#,#,#,#,#,#,#,#,#,#, , , ,#,#,#,#,#, , , , , , , , , , , , , , ,#,#,#,#, , , , , , , ,#,#,#,#,
#,#,#,#,#,#,#,#,#,#,#,#, , , ,#,#,#,#,#,#,#, , , ,#,#, , , , , , ,#,#,#,#,#,#,#, , , , , ,#,#,#,#,#,
#,#,#,#,#,#,#,#,#,#,#,#, , ,#,#,#,#,#,#,#,#,#,#,#,#,#,#, , ,#,#,#,#,#,#,#,#,#,#, , , , , ,#,#,#,#,#,
#,#,#,#,#,#,#,#,#,#,#,#, , ,#,#,#,#,#,#,#,#,#,#,#,#,#,#,#,#,#,#,#,#,#,#,#,#,#,#,#, , , , , ,#,#,#,#,
#,#,#,#,#,#,#,#,#,#,#, , , ,#,#,#,#,#,#,#,#,#,#,#,#,#,#,#,#,#,#,#,#,#,#,#,#,#,#,#,#, , , , , ,#,#,#,
#,#,#,#,#,#,#,#,#,#, , , , , ,#,#,#,#,#,#,#,#,#,#,#,#,#,#,#,#,#,#,#,#,#,#,#,#,#,#,#,#, , , , ,#,#,#,
#,#,#,#,#,#,#,#,#, , , , , , ,#,#,#,#,#,#,#,#,#,#,#,#,#,#,#,#,#,#,#,#,#,#,#,#,#,#,#,#, , , ,#,#,#,#,
#,#,#, ,#,#,#,#,#, , , , , , , ,#,#,#,#,#,#,#,#,#,#,#,#,#,#,#,#,#,#,#, , ,#,#,#,#,#,#, , ,#,#,#,#,#,
#,#, , , ,#,#,#,#, , , , , , , , , ,#,#,#,#,#,#,#,#,#,#,#,#,#,#,#,#, , , , ,#,#,#,#,#,#, ,#,#,#,#,#,
#, , , ,#,#,#,#,#, , , , , , , , , , ,#,#,#,#,#,#,#,#,#,#,#,#,#,#,#, , , , ,#,#,#,#,#,#, , ,#,#,#,#,
#, , ,#,#,#,#,#,#, , , ,#,#,#, , , ,#,#,#,#,#,#,#,#,#,#,#,#,#,#,#,#,#, , , ,#,#,#,#,#,#, , , ,#,#,#,
#, , ,#,#,#,#,#,#, , ,#,#,#,#,#,#,#,#,#,#,#,#,#,#,#,#,#,#,#,#,#,#,#,#, , , ,#,#,#,#,#, , , , ,#,#,#,
#, , ,#,#,#,#,#,#, , ,#,#,#,#,#,#,#,#,#,#,#,#,#,#,#,#,#,#,#,#,#,#,#,#,#, , ,#,#,#,#, , , , ,#,#,#,#,
#, , ,#,#,#,#,#, , , ,#,#,#,#,#,#,#,#,#,#,#,#,#,#,#,#,#,#,#,#,#,#,#,#,#, , , ,#,#, , , , ,#,#,#,#,#,
#, , , ,#,#, , , , , , ,#,#,#,#,#,#,#,#,#,#,#,#,#,#,#,#,#,#,#,#,#,#,#,#, , , , , , , , ,#,#,#,#,#,#,
#, , , , , , , , , , , , ,#,#,#,#, , , , ,#,#,#,#,#,#,#,#,#,#,#,#,#,#,#, , , , , , , ,#,#,#,#,#,#,#,
#,#, , , ,#,#,#, , , , , , , , , , , , , , ,#,#,#,#,#,#,#,#,#,#,#,#,#, , , , , , , ,#,#,#,#,#,#,#,#,
#,#,#,#,#,#,#,#,#, , , , , , , , , , , , , ,#,#,#,#,#,#,#,#,#,#,#, , , , , , , , ,#,#,#,#,#,#,#,#,#,
#,#,#,#,#,#,#,#,#, , , , ,#,#,#,#, , , , ,#,#,#,#,#,#,#,#,#,#,#, , , , ,#,#, , , ,#,#,#,#,#,#,#,#,#,
#,#,#,#,#,#,#,#,#, , , ,#,#,#,#,#,#, , , ,#,#,#,#,#,#,#,#,#,#, , , ,#,#,#,#,#, , , ,#,#,#,#,#,#,#,#,
#,#,#,#,#,#,#,#,#, , , ,#,#,#,#,#,#, , ,#,#,#,#,#,#,#,#,#,#,#, , ,#,#,#,#,#,#, , , , ,#,#,#,#,#,#,#,
#,#,#,#,#,#,#,#,#, , , ,#,#,#,#,#,#, , ,#,#,#,#,#,#,#,#,#,#,#, , ,#,#,#,#,#,#, , , , ,#,#,#,#,#,#,#,
#,#,#,#,#,#,#,#,#, , , , ,#,#,#,#, , , ,#,#,#,#,#,#,#,#,#,#, , , ,#,#,#,#,#,#, , , ,#,#,#,#,#,#,#,#,
#,#,#,#,#,#,#,#,#,#, , , , , , , , , , ,#,#,#,#,#,#,#,#,#,#, , , ,#,#,#,#,#, , , ,#,#,#,#,#,#,#,#,#,
#,#,#,#,#,#,#,#,#,#,#,#,#, , , , , , ,#,#,#,#,#,#,#,#,#,#,#,#, , , ,#,#, , , , , ,#,#,#,#,#,#,#,#,#,
#,#,#,#,#,#,#,#,#,#,#,#,#,#,#,#,#,#,#,#,#,#,#,#,#,#,#,#,#,#,#,#, , , , , , , , ,#,#,#,#,#,#,#,#,#,#,
#,#,#,#,#,#,#,#,#,#,#,#,#,#,#,#,#,#,#,#,#,#,#,#,#,#,#,#,#,#,#,#,#, , , ,#,#,#,#,#,#,#,#,#,#,#,#,#,#,
#,#,#,#,#,#,#,#,#,#,#,#,#,#,#,#,#,#,#,#,#,#,#,#,#,#,#,#,#,#,#,#,#,#,#,#,#,#,#,#,#,#,#,#,#,#,#,#,#,#,
