#,#,#,#,#,#,#,#,#,#,#,#,#,#,#,#,#,#,#,#,#,#,#,#,#,#,#,#,#,#,#,#,#,#,#,#,#,#,#,#,#,#,#,#,#,#,#,#,#,#,
#,#,#,#,#,#,#,#,#,#,#,#,#,#,#,#,#,#,#,#,#,#,#,#,#,#,#,#,#,#,#,#,#,#,#,#, , , , , , , ,#,#,#,#,#,#,#,
#,#,#,#,#,#,#,#,#,#,#, , ,#,#,#,#,#,#,#,#, , , , , ,#,#,#,#,#,#,#,#,#, , , , , , , , , ,#,#,#,#,#,#,
#,#,#,#,#,#,#,#, , , , , , , ,#,#,#,#,#, , , , , , , ,#,#,#,#,#,#, , , ,#,#,#,#,#,#, , , ,#,#,#,#,#,
#,#,#,#,#,#,#, , , , , , , , , ,#,#,#,#, , , , , , , , ,#,#,#,#, , , ,#,#,#,#,#,#,#,#, , , ,#,#,#,#,
#,#,#,#,#,#, , , , ,#,#,#,#, , , ,#,#, , , ,#,#,#, , , , , , , , , , ,#,#,#,#,#,#,#,#, , , , ,#,#,#,
#,#, , , , , , ,#,#,#,#,#,#,#, , , , , , ,#,#,#,#,#, , , , , , , , , , ,#,#,#,#,#,#, , , , , ,#,#,#,
#, , , , , ,#,#,#,#,#,#,#,#,#, , , , , ,#,#,#,#,#,#,#, , , , , , , , , , ,#,#,#,#, , , , , ,#,#,#,#,
#, , , ,#,#,#,#,#,#,#,#,#,#,#, , , , , ,#,#,#,#,#,#,#, , , , , , , , , , , ,#,#, , , ,#,#,#,#,#,#,#,
#, , ,#,#,#,#,#,#,#,#,#,#,#, , , , , , , ,#,#,#,#,#,#, , ,#,#,#,#,#,#, , , , , , , ,#,#,#,#,#,#,#,#,
#, , ,#,#,#,#, , , , , , , , , , , , , , ,#,#,#,#,#, , ,#,#,#,#,#,#,#,#, , , , , , ,#,#,#,#,#,#,#,#,
#, , , ,#,#, , , , , , , , , , , , , , , , ,#,#,#,#, , ,#,#,#,#,#,#,#,#, , , , , , ,#,#,#,#,#,#,#,#,
#, , , , , , ,#,#,#,#,#,#, , ,#,#,#,#,#, , , ,#,#, , ,#,#,#,#,#,#,#,#,#, , , , , , , ,#,#,#,#,#,#,#,
#, , , , , ,#,#,#,#,#,#,#,#,#,#,#,#,#,#,#, , , , , , ,#,#,#,#,#,#,#,#,#, , , , , , , , , ,#,#,#,#,#,
#, , , , , ,#,#,#,#,#,#,#,#,#,#,#,#,#,#,#,#, , , , ,#,#,#,#,#,#,#,#,#,#, , , , , , , , , , ,#,#,#,#,
#,#, , , , , ,#,#,#,#,#,#,#,#,#,#,#,#,#,#,#,#,#,#,#,#,#,#,#,#,#,#,#,#,#, , , ,#,#, , , , , ,#,#,#,#,
#,#, , , , , ,#,#,#,#,#,#,#,#,#,#,#,#,#,#,#,#,#,#,#,#,#,#,#,#,#,#,#,#,#, , ,#,#,#,#, , , , ,#,#,#,#,
#,#, , , , , ,#,#,#,#,#,#,#,#,#,#,#,#,#,#,#,#,#,#,#,#,#,#,#,#,#,#,#,#, , ,#,#,#,#,#,#, , , ,#,#,#,#,
#,#, , , , , ,#,#,#,#,#,#,#,#,#,#,#,#,#,#,#,#,#,#,#,#,#,#,#,#,#,#,#,#, , ,#,#,#,#,#,#, , , ,#,#,#,#,
#,#, , , , , , ,#,#,#,#,#,#,#,#,#,#,#,#,#,#,#,#,#,#,#,#,#,#,#,#,#,#,#, , ,#,#,#,#,#,#, , , ,#,#,#,#,
#,#, , , , , , ,#,#,#,#,#,#,#,#,#,#,#,#,#,#,#,#,#,#,#,#,#,#,#,#,#,#,#,#, ,#,#,#,#,#,#, , , ,#,#,#,#,
#,#, , , , , , , ,#,#,#,#,#,#,#,#,#,#,#,#, , , ,#,#,#,#,#,#,#,#,#,#,#,#, , ,#,#,#,#, , , , , ,#,#,#,
#,#, , , , , , , ,#,#,#,#,#,#,#,#,#,#, , , , , , ,#,#,#,#,#,#,#,#,#,#,#, , , ,#,#,#, , , , , ,#,#,#,
#,#,#, , , , , , , ,#,#,#,#,#,#,#,#,#, , ,#,#, , , , ,#,#,#,#,#,#,#,#,#,#, , ,#,#,#,#, , , , ,#,#,#,
#,#,#,#, , , , , , , , , ,#,#,#,#,#,#,#,#,#,#,#, , , , ,#,#,#,#,#,#,#,#,#, , , ,#,#,#, , , ,#,#,#,#,
#,#,#,#,#,#,#, , , , , , , ,#,#,#,#,#,#,#,#,#,#,#, , , ,#,#,#,#,#,#,#,#,#, , , , , , , , ,#,#,#,#,#,
#,#,#,#,#,#,#,#, , , , , , ,#,#,#,#,#,#,#,#,#,#,#, , ,#,#,#,#,#,#,#,#,#, , , , , , , , ,#,#,#,#,#,#,
#,#,#,#,#,#,#,#,#,#, , , , , ,#,#,#,#,#,#,#,#,#,#, , ,#,#,#,#,#,#,#,#,#, , , , , , , , ,#,#,#,#,#,#,
#,#,#,#,#,#,#,#,#,#, , , , , , , , , ,#,#,#,#,#, , ,#,#,#,#,#,#,#,#,#,#,#, , , , , , , ,#,#,#,#,#,#,
#,#,#,#,#,#,#,#, , , , , , , , , , , , , ,#,#, , ,#,#,#,#,#,#,#,#,#,#,#,#,#, , , , , , , ,#,#,#,#,#,
#,#,#,#,#,#,#, , , , , , , , , , , , , , , , , ,#,#,#,#,#,#,#,#,#,#,#,#,#,#,#, , , , , , , ,#,#,#,#,
#,#,#,#,#,#, , , , , , ,#,#,#,#,#,#,#, , , , ,#,#,#,#,#,#,#,#,#,#,#,#,#,#,#,#, , , ,#,#, , , ,#,#,#,
#,#,#,#,#,#, , , , , ,#,#,#,#,#,#,#,#,#,#,#,#,#,#,#,#,#,#,#,#,#,#,#,#,#,#,#,#, , ,#,#,#,#, ,#,#,#,#,
#,#,#,#,#,#, , , , , ,#,#,#,#,#,#,#,#,#,#,#,#,#,#,#,#,#,#,#,#,#,#,#,#,#,#,#, , , ,#,#,#,#,#,#,#,#,#,
#,#,#,#,#,#,#, , , , , ,#,#,#,#,#,#,#,#,#,#,#,#,#,#,#,#,#,#,#,#,#,#,#,#,#,#, , ,#,#,#,#,#,#,#,#,#,#,
#,#,#,#,#,#,#, , , , , ,#,#,#,#,#,#,#,#,#,#,#,#,#,#,#,#,#,#,#,#,#,#,#,#,#,#, , ,#,#,#,#,#,#,#,#,#,#,
#,#,#,#,#,#,#, , , , , , ,#,#,#,#,#,#,#,#,#,#,#,#,#,#,#,#,#, , , ,#,#,#,#,#, , ,#,#,#,#,#,#,#,#,#,#,
#,#,#,#,#,#,#, , , , , , , ,#,#,#,#,#,#,#,#,#,#,#,#,#,#,#,#, , , , , ,#,#, , , ,#,#,#,#,#,#,#,#,#,#,
#,#,#,#,#,#,#, , , , , , , , ,#,#,#,#,#,#,#,#,#,#,#,#,#,#,#, , , , , , , , , , , ,#,#,#,#, ,#,#,#,#,
#,#,#,#,#,#,#,#, , , ,#,#, , ,#,#,#,#,#,#,#,#,#,#,#,#,#,#,#,#,#,#,#, , , , , , , , , , , , , ,#,#,#,
#,#,#,#,#,#,#,#, , ,#,#,#,#, , ,#,#,#,#,#,#,#,#,#,#,#,#,#,#,#,#,#,#,#, , ,#,#,#, , , , , , , ,#,#,#,
#,#,#,#,#,#,#, , ,#,#,#,#,#, , ,#,#,#,#,#,#,#,#,#,#,#,#,#,#,#,#,#,#,#, ,#,#,#,#,#,#,#,#, , ,#,#,#,#,
#,#,#,#,#,#, , , ,#,#,#,#,#, , ,#,#,#,#,#,#,#,#,#,#,#,#,#,#,#,#,#,#, , ,#,#,#,#,#,#,#,#,#,#,#,#,#,#,
#,#,#,#,#, , , , ,#,#,#,#,#,#,#,#,#,#,#,#,#,#,#,#,#,#,#,#,#,#,#,#, , , ,#,#,#,#,#,#,#,#,#,#,#,#,#,#,
#,#,#,#,#, , , , ,#,#,#,#,#,#,#,#,#,#,#,#,#,#,#,#,#,#,#,#,#,#, , , , ,#,#,#,#,#,#,#,#,#,#,#,#,#,#,#,
#,#,#,#,#, , , , ,#,#,#,#,#,#,#,#,#,#,#,#,#,#,#,#,#,#,#,#,#,#, , , , ,#,#,#,#,#,#,#,#,#,#,#,#,#,#,#,
#,#,#,#,#,#, , ,#,#,#,#,#,#,#,#,#,#,#,#,#,#,#,#,#,#,#,#,#,#,#, , , ,#,#,#,#,#,#,#,#,#,#,#,#,#,#,#,#,
#,#,#,#,#,#,#,#,#,#,#,#,#,#,#,#,#,#,#,#,#,#,#,#,#,#,#,#,#,#,#,#,#,#,#,#,#,#,#,#,#,#,#,#,#,#,#,#,#,#,
#,#,#,#,#,#,#,#,#,#,#,#,#,#,#,#,#,#,#,#,#,#,#,#,#,#,#,#,#,#,#,#,#,#,#,#,#,#,#,#,#,#,#,#,#,#,#,#,#,#,
#,#,#,#,#,#,#,#,#,#,#,#,#,#,#,#,#,#,#,#,#,#,#,#,#,#,#,#,#,#,#,#,#,#,#,#,#,#,#,#,#,#,#,#,#,#,#,#,#,#,
