#,#,#,#,#,#,#,#,#,#,#,#,#,#,#,#,#,#,#,#,#,#,#,#,#,#,#,#,#,#,#,#,#,#,#,#,#,#,#,#,#,#,#,#,#,#,#,#,#,#,
#,#,#,#,#,#,#,#,#,#,#,#,#,#,#,#,#,#,#, , , , , ,#,#,#,#,#,#,#,#,#,#,#,#,#,#,#,#,#,#,#,#,#,#,#,#,#,#,
#,#,#,#, , , , , ,#,#,#,#,#,#,#, , , , , , , , , ,#,#,#,#,#,#,#,#,#,#,#,#,#,#,#,#, , ,#,#,#,#,#,#,#,
#,#, , , , , , , , ,#,#,#,#,#, , , , ,#,#,#,#, , , ,#,#,#,#,#,#,#,#,#,#,#,#, , , , , , ,#,#,#,#,#,#,
#, , , ,#,#,#,#, , , ,#,#,#,#, , , ,#,#,#,#,#,#, , ,#,#,#,#,#,#,#,#,#,#, , , , ,#,#, , , ,#,#,#,#,#,
#, , ,#,#,#,#,#,#, , ,#,#,#,#,#, , ,#,#,#,#,#,#, , ,#,#,#,#,#,#,#,#,#, , , ,#,#,#,#,#, , ,#,#,#,#,#,
#, , ,#,#,#,#,#,#, , ,#,#,#,#,#, , ,#,#,#,#,#,#, ,#,#,#,#,#,#,#,#,#, , , ,#,#,#,#,#,#, , ,#,#,#,#,#,
#, , ,#,#,#,#,#,#, , ,#,#,#,#,#, , ,#,#,#,#,#, , ,#,#,#,#,#,#,#,#,#, , , ,#,#,#,#,#,#, , ,#,#,#,#,#,
#, , ,#,#,#,#,#,#, , ,#,#,#,#, , , , ,#,#, , , , ,#,#,#,#,#,#,#,#,#, , , ,#,#,#,#,#, , ,#,#,#,#,#,#,
#,#, , ,#,#,#,#, , ,#,#,#,#, , , , , , , , , , ,#,#,#,#,#,#,#,#,#,#,#, , , ,#,#,#,#, , ,#,#,#,#,#,#,
#,#, , , ,#,#,#, , ,#,#,#,#, , , , , , , , , ,#,#,#,#,#,#,#,#,#,#,#,#,#, , , ,#,#, , , ,#,#,#,#,#,#,
#,#,#, , , ,#,#,#, , ,#,#, , , , , , , , , ,#,#,#,#,#,#,#,#,#,#,#,#,#,#,#, , , , , , , , ,#,#,#,#,#,
#,#,#,#, , , ,#,#,#, , , , , , , , ,#,#,#,#,#,#,#,#,#,#,#,#,#,#,#,#,#,#,#,#, , , , , , , , ,#,#,#,#,
#,#,#,#,#, , , ,#,#,#, , , , , , ,#,#,#,#,#,#,#,#,#,#,#,#,#,#,#,#, , ,#,#,#, , , , , , , , , ,#,#,#,
#,#,#,#,#,#, , , ,#,#,#,#,#, , , ,#,#,#,#,#,#,#,#,#,#,#,#,#,#,#, , , , ,#,#, , , , , , , , , ,#,#,#,
#,#,#,#,#,#,#, , ,#,#,#,#,#,#, , , ,#,#,#,#,#,#,#,#,#,#,#,#,#, , , , , ,#,#,#, , , , ,#, , , ,#,#,#,
#,#,#,#,#,#,#, , ,#,#,#,#,#,#, , , ,#,#,#,#,#,#,#, , ,#,#,#,#, , , , ,#,#,#,#,#, , ,#,#,#, , ,#,#,#,
#,#,#,#,#,#,#, , ,#,#,#,#,#,#, , , ,#,#,#,#,#,#, , , , ,#,#, , , , , ,#,#,#,#,#, , ,#,#,#, , ,#,#,#,
#,#,#,#,#,#,#, , , ,#,#,#,#, , , ,#,#,#,#,#,#, , , , , , , , , , , , ,#,#,#,#,#, , , ,#, , , ,#,#,#,
#,#,#,#,#,#, , , , , , , , , , , ,#,#,#,#,#, , , ,#,#,#, , , , , , , , ,#,#,#,#, , , , , , , , ,#,#,
#,#, , , , , , , , , , , , , , ,#,#,#,#,#, , , ,#,#,#,#,#, , , , , , , , ,#,#, , , , , , , , , ,#,#,
#, , , , , , , , , , , ,#,#,#,#,#,#,#,#, , , , ,#,#,#,#,#,#, , , , , , , , , , , ,#,#,#, , , , ,#,#,
#, , , ,#,#, , , , , ,#,#,#,#,#,#,#,#,#, , , , ,#,#,#,#,#,#, , , , , , , , , ,#,#,#,#,#,#, , ,#,#,#,
#, , ,#,#,#,#, , , , ,#,#,#,#,#,#,#,#,#, , , , , ,#,#,#,#, , , , , , , , , ,#,#,#,#,#,#,#,#,#,#,#,#,
#, , ,#,#,#,#, , , , ,#,#,#,#,#,#,#,#,#, , , , , , , , , , , , , , , , , , ,#,#,#,#,#,#,#,#,#,#,#,#,
#, , ,#,#,#,#,#, , , ,#,#,#,#,#,#,#,#,#, , , , , , , , , , , ,#,#, , , , , , ,#,#,#,#,#,#,#,#,#,#,#,
#, , ,#,#,#,#,#, , , , ,#,#, , , ,#,#, , , , , ,#,#,#,#,#,#,#,#,#,#, , , , , , ,#,#,#,#,#,#,#,#,#,#,
#, , , ,#,#,#, , , , , , , , , , , , , , , , ,#,#,#,#,#,#,#,#,#,#,#,#,#,#, , , ,#,#,#, , ,#,#,#,#,#,
#,#, , , , , , , , , , , , ,#,#,#, , , , , ,#,#,#,#,#,#,#,#,#,#,#,#,#,#,#,#, , , , , , , ,#,#,#,#,#,
#,#,#, , , , , , , , , , ,#,#,#,#,#,#, , ,#,#,#,#,#,#,#,#,#,#,#,#,#,#,#,#,#, , , , , , , ,#,#,#,#,#,
#,#,#,#,#,#, , , , , , ,#,#,#,#,#,#,#,#,#,#,#,#,#,#,#,#,#,#,#,#,#,#,#,#,#,#, , , , , , , ,#,#,#,#,#,
#,#,#,#,#,#,#, , , , , ,#,#,#,#,#,#,#,#,#,#,#,#,#,#,#,#,#,#,#,#,#,#,#,#,#,#, , , , , , , , ,#,#,#,#,
#,#,#,#,#,#,#,#,#, , , , ,#,#,#,#,#,#,#,#,#,#,#,#,#,#,#,#,#,#,#,#,#,#,#,#,#, , , , , , , , ,#,#,#,#,
#,#,#,#,#,#,#,#,#,#, , , ,#,#,#,#,#,#,#,#,#,#,#,#,#,#,#,#,#,#,#,#,#,#,#,#,#, , , , , , , , ,#,#,#,#,
#,#,#,#,#,#,#,#,#,#, , , ,#,#,#,#,#,#,#,#,#,#,#,#,#,#,#,#,#,#,#, , ,#,#,#,#, , , , , , , , ,#,#,#,#,
#,#,#,#,#,#,#,#,#, , , , , ,#,#,#,#,#,#,#,#,#,#,#,#,#,#,#,#,#, , , , ,#,#, , , , , , , , ,#,#,#,#,#,
#,#,#,#,#,#,#,#, , , , , , , , , ,#,#,#,#,#,#,#,#,#,#,#,#,#,#, , , , , , , , , , , , , ,#,#,#,#,#,#,
#,#,#,#,#,#,#, , , , , , , , , , ,#,#,#,#,#,#,#,#,#,#,#,#,#,#, , , , , , , , , , , ,#,#,#,#,#,#,#,#,
#,#,#,#,#,#, , , ,#,#, , , , , ,#,#,#,#,#,#,#,#,#,#,#,#,#,#,#,#,#,#,#,#,#,#, , , ,#,#,#,#,#,#,#,#,#,
#,#,#,#,#, , , ,#,#,#,#, , , ,#,#,#,#,#,#,#,#,#,#,#,#,#,#,#,#,#,#,#,#,#,#,#,#, , ,#,#,#,#,#,#,#,#,#,
#,#,#,#, , , , ,#,#,#,#,#, , ,#,#,#,#,#,#,#,#,#,#,#,#,#,#,#,#,#,#,#,#,#,#,#,#, , ,#,#,#,#,#,#,#,#,#,
#,#,#, , , , ,#,#,#,#,#,#, , , ,#,#,#,#,#,#,#,#,#,#,#,#,#,#,#,#,#,#,#,#,#,#, , , ,#,#,#,#,#,#,#,#,#,
#,#,#, , , , ,#,#,#,#,#,#, , , , ,#,#,#,#,#,#,#,#,#,#,#,#,#,#,#,#,#,#,#,#,#, , , ,#,#,#,#,#,#,#,#,#,
#,#,#, , , , ,#,#,#,#,#, , , , , ,#,#,#,#,#,#,#,#,#,#,#,#,#,#,#,#,#,#,#,#, , , , ,#,#,#,#,#,#,#,#,#,
#,#,#,#, , , ,#,#,#,#, , , , , , ,#,#,#,#,#,#,#,#,#,#,#,#,#,#,#,#, , , , , , , ,#,#,#,#,#,#,#,#,#,#,
#,#,#,#,#, , , ,#,#, , , , ,#,#,#,#,#,#,#,#,#,#,#,#,#,#,#,#,#,#,#, , , , , , ,#,#,#,#,#,#,#,#,#,#,#,
#,#,#,#,#,#, , , , , , , ,#,#,#,#,#,#,#,#,#,#,#,#,#,#,#,#,#,#,#,#,#,#,#,#,#,#,#,#,#,#,#,#,#,#,#,#,#,
#,#,#,#,#,#,#, , , , , ,#,#,#,#,#,#,#,#,#,#,#,#,#,#,#,#,#,#,#,#,#,#,#,#,#,#,#,#,#,#,#,#,#,#,#,#,#,#,
#,#,#,#,#,#,#,#,#,#,#,#,#,#,#,#,#,#,#,#,#,#,#,#,#,#,#,#,#,#,#,#,#,#,#,#,#,#,#,#,#,#,#,#,#,#,#,#,#,#,
#,#,#,#,#,#,#,#,#,#,#,#,#,#,#,#,#,#,#,#,#,#,#,#,#,#,#,#,#,#,#,#,#,#,#,#,#,#,#,#,#,#,#,#,#,#,#,#,#,#,
