#,#,#,#,#,#,#,#,#,#,#,#,#,#,#,#,#,#,#,#,#,#,#,#,#,#,#,#,#,#,#,#,#,#,#,#,#,#,#,#,#,#,#,#,#,#,#,#,#,#,
#,#,#,#,#,#,#,#,#,#,#,#,#,#,#,#,#,#,#,#,#,#,#,#,#,#,#,#,#,#, , , , , , , , ,#,#,#,#,#,#,#,#,#,#,#,#,
#,#,#,#,#,#,#,#, , , ,#,#,#,#,#,#,#,#,#,#,#,#,#,#,#,#,#,#, , , , , , , , , , ,#,#,#,#,#,#,#,#,#,#,#,
#,#,#,#,#,#,#, , , , , ,#,#,#,#,#,#,#,#,#,#,#,#,#,#,#,#, , , , , ,#,#,#, , , , ,#,#,#,#,#,#,#,#,#,#,
#,#,#,#,#, , , , , , , , ,#,#,#,#,#,#,#,#,#,#,#,#,#,#, , , , , ,#,#,#,#,#, , , ,#,#,#,#,#,#,#,#,#,#,
#,#,#,#, , , ,#,#,#, , , ,#,#,#,#,#,#,#,#,#,#,#,#,#,#, , , ,#,#,#,#,#,#,#, , , ,#,#,#,#,#,#,#,#,#,#,
#,#,#,#, , ,#,#,#,#,#, , , ,#,#,#,#,#,#,#,#,#,#,#,#,#, , ,#,#,#,#,#,#,#, , , , ,#,#,#,#,#,#,#,#,#,#,
#,#,#,#, , ,#,#,#,#,#, , , ,#,#,#,#,#,#,#,#,#,#,#,#,#, , , ,#,#, , , , , , , , , ,#,#,#,#,#,#,#,#,#,
#,#,#,#, , ,#,#,#,#,#, , , ,#,#,#,#,#,#,#,#,#,#,#,#, , , , , , , , , , , , , , , , , , , ,#,#,#,#,#,
#,#,#,#, , ,#,#,#,#, , , ,#,#,#,#,#, , ,#,#,#,#, , , , , , , , , ,#,#,#, , , , , , , , , , ,#,#,#,#,
#,#,#,#,#, , ,#,#, , , , ,#,#,#,#, , , , , , , , , , , , , , , ,#,#,#,#,#, , , , , , , , ,#,#,#,#,#,
#,#,#,#,#, , , , , , , ,#,#,#,#,#, , , , , , , , , , , , , , , ,#,#,#,#,#, , , , , , , , ,#,#,#,#,#,
#,#,#,#,#,#, , , , , ,#,#,#,#,#,#,#, , , , ,#,#,#,#,#, , , , , ,#,#,#,#, , , , , , , , , ,#,#,#,#,#,
#,#,#,#,#,#,#, , , ,#,#,#,#,#,#,#,#, , , ,#,#,#,#,#,#,#, , , , ,#,#,#,#, , , , ,#,#, , , , ,#,#,#,#,
#,#,#,#,#,#,#, , , ,#,#,#,#,#,#,#,#, , , ,#,#,#,#,#,#,#, , , , ,#,#,#,#,#, , , ,#,#,#, , , , ,#,#,#,
#,#,#,#,#,#, , , , , ,#,#,#,#,#,#,#,#, , , ,#,#,#,#,#, , , , ,#,#,#,#,#,#, , ,#,#,#,#,#, , , ,#,#,#,
#,#,#,#,#,#, , , , , ,#,#,#,#,#,#,#,#,#, , , ,#,#,#, , , ,#,#,#,#,#,#,#,#,#,#,#,#,#,#,#,#, , ,#,#,#,
#,#,#,#,#, , , , , , ,#,#,#,#,#,#,#,#,#, , , , , , , ,#,#,#,#,#,#,#,#,#,#,#,#,#,#,#,#,#,#, , ,#,#,#,
#,#,#,#, , , , , , , ,#,#,#,#,#,#,#,#,#,#, , , , , ,#,#,#,#,#,#,#,#,#,#,#,#,#,#,#,#,#,#,#, , ,#,#,#,
#,#,#, , , , , , , , , ,#,#,#,#,#,#,#,#,#, , , , , ,#,#,#,#,#,#,#,#,#,#,#,#,#,#,#,#,#,#, , ,#,#,#,#,
#,#, , , , ,#,#, , , , , , , , ,#,#,#,#, , , ,#,#, ,#,#,#,#,#,#,#,#,#,#,#,#,#,#, ,#,#, , , ,#,#,#,#,
#,#, , , ,#,#,#,#, , , , , , , , , , , , , , ,#, , , ,#,#,#,#,#,#,#,#,#,#,#,#, , , , , , , ,#,#,#,#,
#,#, , , ,#,#,#,#, , , , , , , , , , , , , , , , , , ,#,#,#,#,#,#,#,#,#,#,#,#,#, , , , , , , ,#,#,#,
#,#, , ,#,#,#,#,#,#, , , , , , , , , ,#,#,#,#, , , , ,#,#,#,#,#,#,#,#,#,#,#,#,#,#, , , , , , ,#,#,#,
#,#, , ,#,#,#,#,#,#, , , , , , , , ,#,#,#,#,#,#, , ,#,#,#,#,#,#,#,#,#,#,#,#,#,#,#,#, , , , , ,#,#,#,
#,#, , ,#,#,#,#,#, , , , , , , , ,#,#,#,#,#,#,#, , ,#,#,#,#,#, , ,#,#,#,#,#,#,#,#,#,#,#,#, ,#,#,#,#,
#,#, , ,#,#,#,#, , , , , , , , ,#,#,#,#,#,#,#,#, , ,#,#,#,#,#, , , , ,#,#,#,#,#,#,#,#,#,#,#,#,#,#,#,
#,#, , , ,#,#, , , , , , , , , ,#,#,#,#,#,#,#,#, , , ,#,#,#,#,#, , , , ,#,#,#,#,#,#,#,#,#,#,#,#,#,#,
#,#,#, , , , , , , , , , , , , , ,#,#,#,#,#,#,#, , , ,#,#,#,#, , , , ,#,#,#,#,#,#,#,#,#,#,#,#,#,#,#,
#,#,#, , , , , ,#,#,#,#,#,#,#, , , ,#,#,#,#,#,#, , , ,#,#,#,#, , ,#,#,#,#,#,#,#,#,#,#,#,#,#,#,#,#,#,
#,#,#,#, , , ,#,#,#,#,#,#,#,#,#, , , ,#,#,#,#,#,#, , , ,#,#, , ,#,#,#,#,#,#,#,#,#,#,#,#,#,#,#,#,#,#,
#,#,#,#,#,#,#,#,#,#,#,#,#,#,#,#,#, , , , , ,#,#,#,#, , , , , ,#,#,#,#,#,#,#,#,#,#,#,#,#,#,#,#,#,#,#,
#,#,#,#,#,#,#,#,#,#,#,#,#,#,#,#,#,#, , , , , ,#,#,#,#, , , , ,#,#,#,#,#,#,#,#,#,#,#,#,#,#,#,#,#,#,#,
#,#,#,#,#,#,#,#,#,#,#,#,#,#,#,#,#,#,#, , , , ,#,#,#,#, , , , , ,#,#,#,#,#,#,#,#,#,#,#,#,#,#,#,#,#,#,
#,#,#,#,#,#,#,#,#,#,#,#,#,#,#,#,#,#,#,#, , , , ,#,#, , ,#,#, , , , , , ,#,#,#,#,#,#, , , , ,#,#,#,#,
#,#,#,#, , ,#,#,#,#,#,#,#,#,#,#,#,#,#,#,#,#, , , , , ,#,#,#,#,#, , , , , ,#,#,#, , , , , , , ,#,#,#,
#,#,#, , , , , , , , , ,#,#,#,#,#,#,#,#,#,#,#, , , , ,#,#,#,#,#,#,#,#, , , , , , , , ,#,#, , , ,#,#,
#,#, , , , , , , , , , , ,#,#,#,#,#,#,#,#,#,#, , , ,#,#,#,#,#,#,#,#,#,#, , , , ,#,#,#,#,#,#, , ,#,#,
#, , , ,#,#,#, , , , , , , ,#,#,#,#,#,#,#,#, , , , ,#,#,#,#,#,#,#,#,#,#, , , ,#,#,#,#,#,#,#, , ,#,#,
#, , ,#,#,#,#,#, , , , , , ,#,#,#,#,#,#,#,#, , , , , ,#,#,#,#,#,#,#,#,#, , , ,#,#,#,#,#,#, , ,#,#,#,
#, , ,#,#,#,#,#,#,#, , , , ,#,#,#,#,#,#,#,#,#, , , , , , , , ,#,#,#,#, , , , , ,#,#,#,#,#, , ,#,#,#,
#, , ,#,#,#,#,#,#,#,#,#,#,#,#,#,#,#,#,#,#,#,#, , , , , , , , , , , , , , , , , ,#,#,#,#,#, , , ,#,#,
#, , , ,#,#,#,#,#,#,#,#,#,#,#,#,#,#,#,#,#,#, , , , , ,#,#, , , , , , ,#,#,#, , , ,#,#,#, , , , ,#,#,
#,#, , , , , , , , , ,#,#,#,#,#,#,#,#,#,#, , , , , ,#,#,#,#, , , ,#,#,#,#,#,#, , , , , , , , ,#,#,#,
#,#,#, , , , , , , , , ,#,#,#,#,#,#,#, , , ,#,#,#,#,#,#,#,#,#,#,#,#,#,#,#,#,#,#, , , , , , ,#,#,#,#,
#,#,#,#,#,#,#,#,#,#, , , , , , , , , , , ,#,#,#,#,#,#,#,#,#,#,#,#,#,#,#,#,#,#,#,#,#,#,#,#,#,#,#,#,#,
#,#,#,#,#,#,#,#,#,#,#, , , , , , , , , ,#,#,#,#,#,#,#,#,#,#,#,#,#,#,#,#,#,#,#,#,#,#,#,#,#,#,#,#,#,#,
#,#,#,#,#,#,#,#,#,#,#, , , , ,#,#,#,#,#,#,#,#,#,#,#,#,#,#,#,#,#,#,#,#,#,#,#,#,#,#,#,#,#,#,#,#,#,#,#,
#,#,#,#,#,#,#,#,#,#,#,#, , ,#,#,#,#,#,#,#,#,#,#,#,#,#,#,#,#,#,#,#,#,#,#,#,#,#,#,#,#,#,#,#,#,#,#,#,#,
#,#,#,#,#,#,#,#,#,#,#,#,#,#,#,#,#,#,#,#,#,#,#,#,#,#,#,#,#,#,#,#,#,#,#,#,#,#,#,#,#,#,#,#,#,#,#,#,#,#,
